year,brood,offspring,rank,dam,sire,dam.type,sire.type,hothiphop.parents,hiphop,hot.parents,hot.dam,hot.sire,hothiphop.dam,hothiphop.sire,below.threshold,threshold,loci.dyad.dam,loci.dyad.sire,loci.triad,offspring.heterozygosity,social.mother.sampled,social.father.sampled,social.mother,social.father,condition,ranking,ranking2
2019,1,WCR2019_0646,1,WCR2019_0267,WCR2019_0494,within-group subordinate,within-group subordinate,29,8,21,10,11,18,19,1,99999,8314,8332,8272,0.146029850746269,0,0,NA,NA,none,hothiphop.parents,hot.parents
2019,1,WCR2019_0646,2,WCR2019_0324,WCR2019_0494,within-group subordinate,within-group subordinate,181,134,47,39,11,173,145,1,99999,8362,8332,8320,0.146029850746269,0,0,NA,NA,none,hothiphop.parents,hot.parents
2019,1,WCR2019_0646,3,WCR2019_0008,WCR2019_0494,within-group subordinate,within-group subordinate,186,158,28,20,11,178,169,1,99999,8240,8332,8197,0.146029850746269,0,0,NA,NA,none,hothiphop.parents,hot.parents
2019,1,WCR2019_0648,1,WCR2019_0223,WCR2019_0103,within-group subordinate,within-group subordinate,207,153,54,50,5,203,158,1,99999,5741,7827,5708,0.0816067115800178,0,0,NA,NA,none,hothiphop.parents,hot.parents
2019,1,WCR2019_0648,2,WCR2019_0008,WCR2019_0103,within-group subordinate,within-group subordinate,219,185,34,31,5,216,190,1,99999,7743,7827,7703,0.0816067115800178,0,0,NA,NA,none,hothiphop.parents,hot.parents
2019,1,WCR2019_0648,3,WCR2019_0440,WCR2019_0103,within-group subordinate,within-group subordinate,229,182,47,44,5,226,187,1,99999,6554,7827,6515,0.0816067115800178,0,0,NA,NA,none,hothiphop.parents,hot.parents
2019,1,WCR2019_0649,1,WCR2019_0223,WCR2019_0641,within-group subordinate,within-group subordinate,251,228,23,23,16,251,244,1,99999,6071,6176,4561,0.186469041357877,0,0,NA,NA,none,hothiphop.parents,hot.parents
2019,1,WCR2019_0649,2,WCR2019_0223,WCR2019_0088,within-group subordinate,within-group subordinate,275,255,20,23,12,278,267,1,99999,6071,7396,5352,0.186469041357877,0,0,NA,NA,none,hothiphop.parents,hot.parents
2019,1,WCR2019_0649,3,WCR2019_0223,WCR2019_0075,within-group subordinate,within-group subordinate,282,259,23,23,9,282,268,1,99999,6071,7821,5640,0.186469041357877,0,0,NA,NA,none,hothiphop.parents,hot.parents
2019,1,WCR2019_0650,1,WCR2019_0223,WCR2019_0641,within-group subordinate,within-group subordinate,250,229,21,24,11,253,240,1,99999,6071,6173,4559,0.187522409465758,0,0,NA,NA,none,hothiphop.parents,hot.parents
2019,1,WCR2019_0650,2,WCR2019_0223,WCR2019_0088,within-group subordinate,within-group subordinate,283,264,19,24,6,288,270,1,99999,6071,7398,5354,0.187522409465758,0,0,NA,NA,none,hothiphop.parents,hot.parents
2019,1,WCR2019_0650,3,WCR2019_0223,WCR2019_0075,within-group subordinate,within-group subordinate,283,259,24,24,7,283,266,1,99999,6071,7824,5642,0.187522409465758,0,0,NA,NA,none,hothiphop.parents,hot.parents
2019,1,WCR2019_0654,1,WCR2019_0223,WCR2019_0475,within-group subordinate,within-group subordinate,223,172,51,49,8,221,180,1,99999,6075,8344,6063,0.153285543608124,0,0,NA,NA,none,hothiphop.parents,hot.parents
2019,1,WCR2019_0654,2,WCR2019_0440,WCR2019_0475,within-group subordinate,within-group subordinate,252,200,52,50,8,250,208,1,99999,6959,8344,6939,0.153285543608124,0,0,NA,NA,none,hothiphop.parents,hot.parents
2019,1,WCR2019_0654,3,WCR2019_0008,WCR2019_0475,within-group subordinate,within-group subordinate,254,227,27,25,8,252,235,1,99999,8233,8344,8207,0.153285543608124,0,0,NA,NA,none,hothiphop.parents,hot.parents
2019,1,WCR2019_0656,1,WCR2019_0223,WCR2019_0641,within-group subordinate,within-group subordinate,338,261,77,48,89,309,350,1,99999,6064,6170,4553,0.0909090909090909,0,0,NA,NA,none,hothiphop.parents,hot.parents
2019,1,WCR2019_0656,2,WCR2019_0223,WCR2019_0087,within-group subordinate,within-group subordinate,356,289,67,48,67,337,356,1,99999,6064,7301,5270,0.0909090909090909,0,0,NA,NA,none,hothiphop.parents,hot.parents
2019,1,WCR2019_0656,3,WCR2019_0126,WCR2019_0641,within-group subordinate,within-group subordinate,359,234,125,134,89,368,323,1,99999,5304,6170,3958,0.0909090909090909,0,0,NA,NA,none,hothiphop.parents,hot.parents
2019,1,WCR2019_0658,1,WCR2019_0532,WCR2019_0327,within-group subordinate,within-group subordinate,330,283,47,6,46,289,329,1,99999,8305,8220,8157,0.0954485724525146,0,0,NA,NA,none,hothiphop.parents,hot.parents
2019,1,WCR2019_0658,2,WCR2019_0532,WCR2019_0087,within-group subordinate,within-group subordinate,332,260,72,6,70,266,330,1,99999,8305,7311,7251,0.0954485724525146,0,0,NA,NA,none,hothiphop.parents,hot.parents
2019,1,WCR2019_0658,3,WCR2019_0532,WCR2019_0641,within-group subordinate,within-group subordinate,344,239,105,6,106,245,345,1,99999,8305,6175,6122,0.0954485724525146,0,0,NA,NA,none,hothiphop.parents,hot.parents
2019,1,WCR2019_0659,1,WCR2019_0223,WCR2019_0641,within-group subordinate,within-group subordinate,365,268,97,67,97,335,365,1,99999,6061,6164,4551,0.0967201340675126,0,0,NA,NA,none,hothiphop.parents,hot.parents
2019,1,WCR2019_0659,2,WCR2019_0126,WCR2019_0641,within-group subordinate,within-group subordinate,385,254,131,124,97,378,351,1,99999,5300,6164,3951,0.0967201340675126,0,0,NA,NA,none,hothiphop.parents,hot.parents
2019,1,WCR2019_0659,3,WCR2019_0223,WCR2019_0327,within-group subordinate,within-group subordinate,394,319,75,67,43,386,362,1,99999,6061,8203,5975,0.0967201340675126,0,0,NA,NA,none,hothiphop.parents,hot.parents
2019,1,WCR2019_0660,1,WCR2019_0208,WCR2019_0327,within-group subordinate,within-group subordinate,366,313,53,34,28,347,341,1,99999,8277,8219,8131,0.119369100250926,0,0,NA,NA,none,hothiphop.parents,hot.parents
2019,1,WCR2019_0660,2,WCR2019_0208,WCR2019_0641,within-group subordinate,within-group subordinate,377,280,97,34,86,314,366,1,99999,8277,6174,6112,0.119369100250926,0,0,NA,NA,none,hothiphop.parents,hot.parents
2019,1,WCR2019_0660,3,WCR2019_0223,WCR2019_0641,within-group subordinate,within-group subordinate,381,301,80,45,86,346,387,1,99999,6073,6174,4559,0.119369100250926,0,0,NA,NA,none,hothiphop.parents,hot.parents
2019,1,WCR2019_0661,1,WCR2019_0223,WCR2019_0641,within-group subordinate,within-group subordinate,322,239,83,71,72,310,311,1,99999,6069,6172,4557,0.113660810326282,0,0,NA,NA,none,hothiphop.parents,hot.parents
2019,1,WCR2019_0661,2,WCR2019_0440,WCR2019_0641,within-group subordinate,within-group subordinate,347,272,75,51,72,323,344,1,99999,6954,6172,5173,0.113660810326282,0,0,NA,NA,none,hothiphop.parents,hot.parents
2019,1,WCR2019_0661,3,WCR2019_0126,WCR2019_0641,within-group subordinate,within-group subordinate,366,228,138,153,72,381,300,1,99999,5308,6172,3958,0.113660810326282,0,0,NA,NA,none,hothiphop.parents,hot.parents
2019,1,WCR2019_0662,1,WCR2019_0223,WCR2019_0641,within-group subordinate,within-group subordinate,249,203,46,34,54,237,257,1,99999,6062,6168,4551,0.130637636080871,0,0,NA,NA,none,hothiphop.parents,hot.parents
2019,1,WCR2019_0662,2,WCR2019_0223,WCR2019_0327,within-group subordinate,within-group subordinate,305,265,40,34,29,299,294,1,99999,6062,8209,5977,0.130637636080871,0,0,NA,NA,none,hothiphop.parents,hot.parents
2019,1,WCR2019_0662,3,WCR2019_0223,WCR2019_0075,within-group subordinate,within-group subordinate,314,262,52,34,52,296,314,1,99999,6062,7814,5631,0.130637636080871,0,0,NA,NA,none,hothiphop.parents,hot.parents
2019,1,WCR2019_0663,1,WCR2019_0223,WCR2019_0641,within-group subordinate,within-group subordinate,402,333,69,41,76,374,409,1,99999,6050,6162,4547,0.126512519468072,0,0,NA,NA,none,hothiphop.parents,hot.parents
2019,1,WCR2019_0663,2,WCR2019_0482,WCR2019_0641,within-group subordinate,within-group subordinate,402,317,85,26,76,343,393,1,99999,8242,6162,6091,0.126512519468072,0,0,NA,NA,none,hothiphop.parents,hot.parents
2019,1,WCR2019_0663,3,WCR2019_0223,WCR2019_0087,within-group subordinate,within-group subordinate,432,378,54,41,37,419,415,1,99999,6050,7287,5255,0.126512519468072,0,0,NA,NA,none,hothiphop.parents,hot.parents
2019,1,WCR2019_0664,1,WCR2019_0532,WCR2019_0327,within-group subordinate,within-group subordinate,291,253,38,9,38,262,291,1,99999,8292,8207,8144,0.0941612826034937,0,0,NA,NA,none,hothiphop.parents,hot.parents
2019,1,WCR2019_0664,2,WCR2019_0532,WCR2019_0087,within-group subordinate,within-group subordinate,322,258,64,9,64,267,322,1,99999,8292,7302,7242,0.0941612826034937,0,0,NA,NA,none,hothiphop.parents,hot.parents
2019,1,WCR2019_0664,3,WCR2019_0532,WCR2019_0230,within-group subordinate,within-group subordinate,322,251,71,9,71,260,322,1,99999,8292,8188,8129,0.0941612826034937,0,0,NA,NA,none,hothiphop.parents,hot.parents
2019,1,WCR2019_0665,1,WCR2019_0223,WCR2019_0087,within-group subordinate,within-group subordinate,297,235,62,47,49,282,284,1,99999,5833,7020,5109,0.0911255953873151,0,0,NA,NA,none,hothiphop.parents,hot.parents
2019,1,WCR2019_0665,2,WCR2019_0223,WCR2019_0641,within-group subordinate,within-group subordinate,297,217,80,47,88,264,305,1,99999,5833,5906,4395,0.0911255953873151,0,0,NA,NA,none,hothiphop.parents,hot.parents
2019,1,WCR2019_0665,3,WCR2019_0223,WCR2019_0327,within-group subordinate,within-group subordinate,319,265,54,47,30,312,295,1,99999,5833,7834,5751,0.0911255953873151,0,0,NA,NA,none,hothiphop.parents,hot.parents
2019,1,WCR2019_0666,1,WCR2019_0565,WCR2019_0216,within-group subordinate,within-group subordinate,20,10,10,6,5,16,15,1,99999,8310,8310,8244,0.112225405921681,0,0,NA,NA,none,hothiphop.parents,hot.parents
2019,1,WCR2019_0666,2,WCR2019_0223,WCR2019_0216,within-group subordinate,within-group subordinate,225,190,35,33,5,223,195,1,99999,6076,8310,6040,0.112225405921681,0,0,NA,NA,none,hothiphop.parents,hot.parents
2019,1,WCR2019_0666,3,WCR2019_0565,WCR2019_0327,within-group subordinate,within-group subordinate,286,257,29,6,27,263,284,1,99999,8310,8225,8162,0.112225405921681,0,0,NA,NA,none,hothiphop.parents,hot.parents
2019,1,WCR2019_0668,1,WCR2019_0585,WCR2019_0087,within-group subordinate,within-group subordinate,303,245,58,6,56,251,301,1,99999,8348,7311,7289,0.0929288103201147,0,0,NA,NA,none,hothiphop.parents,hot.parents
2019,1,WCR2019_0668,2,WCR2019_0585,WCR2019_0122,within-group subordinate,within-group subordinate,305,250,55,6,51,256,301,1,99999,8348,8306,8282,0.0929288103201147,0,0,NA,NA,none,hothiphop.parents,hot.parents
2019,1,WCR2019_0668,3,WCR2019_0585,WCR2019_0327,within-group subordinate,within-group subordinate,307,264,43,6,40,270,304,1,99999,8348,8221,8198,0.0929288103201147,0,0,NA,NA,none,hothiphop.parents,hot.parents
2019,1,WCR2019_0669,1,WCR2019_0223,WCR2019_0216,within-group subordinate,within-group subordinate,228,187,41,38,5,225,192,1,99999,5882,7997,5854,0.0934939160665508,0,0,NA,NA,none,hothiphop.parents,hot.parents
2019,1,WCR2019_0669,2,WCR2019_0219,WCR2019_0216,within-group subordinate,within-group subordinate,259,214,45,41,5,255,219,1,99999,7325,7997,7276,0.0934939160665508,0,0,NA,NA,none,hothiphop.parents,hot.parents
2019,1,WCR2019_0669,3,WCR2019_0076,WCR2019_0216,within-group subordinate,within-group subordinate,260,212,48,44,5,256,217,1,99999,6917,7997,6863,0.0934939160665508,0,0,NA,NA,none,hothiphop.parents,hot.parents
2019,1,WCR2019_0670,1,WCR2019_0076,WCR2019_0327,within-group subordinate,within-group subordinate,222,203,19,2,23,205,226,1,99999,7120,8123,6985,0.0944034812039164,0,0,NA,NA,none,hothiphop.parents,hot.parents
2019,1,WCR2019_0670,2,WCR2019_0076,WCR2019_0122,within-group subordinate,within-group subordinate,234,202,32,2,42,204,244,1,99999,7120,8207,7072,0.0944034812039164,0,0,NA,NA,none,hothiphop.parents,hot.parents
2019,1,WCR2019_0670,3,WCR2019_0076,WCR2019_0641,within-group subordinate,within-group subordinate,249,177,72,2,88,179,265,1,99999,7120,6104,5266,0.0944034812039164,0,0,NA,NA,none,hothiphop.parents,hot.parents
2019,1,WCR2019_0671,1,WCR2019_0585,WCR2019_0327,within-group subordinate,within-group subordinate,293,249,44,10,38,259,287,1,99999,8346,8219,8196,0.0909199522102748,0,0,NA,NA,none,hothiphop.parents,hot.parents
2019,1,WCR2019_0671,2,WCR2019_0585,WCR2019_0087,within-group subordinate,within-group subordinate,303,235,68,10,63,245,298,1,99999,8346,7308,7286,0.0909199522102748,0,0,NA,NA,none,hothiphop.parents,hot.parents
2019,1,WCR2019_0671,3,WCR2019_0585,WCR2019_0161,within-group subordinate,within-group subordinate,315,252,63,10,56,262,308,1,99999,8346,8236,8212,0.0909199522102748,0,0,NA,NA,none,hothiphop.parents,hot.parents
2019,1,WCR2019_0672,1,WCR2019_0223,WCR2019_0087,within-group subordinate,within-group subordinate,357,282,75,58,63,340,345,1,99999,6064,7303,5269,0.0885939741750359,0,0,NA,NA,none,hothiphop.parents,hot.parents
2019,1,WCR2019_0672,2,WCR2019_0223,WCR2019_0641,within-group subordinate,within-group subordinate,362,267,95,58,101,325,368,1,99999,6064,6172,4554,0.0885939741750359,0,0,NA,NA,none,hothiphop.parents,hot.parents
2019,1,WCR2019_0672,3,WCR2019_0223,WCR2019_0073,within-group subordinate,within-group subordinate,374,295,79,58,64,353,359,1,99999,6064,7974,5746,0.0885939741750359,0,0,NA,NA,none,hothiphop.parents,hot.parents
2019,1,WCR2019_0675,1,WCR2019_0223,WCR2019_0216,within-group subordinate,within-group subordinate,237,190,47,44,5,234,195,1,99999,5964,8163,5928,0.102199538218496,0,0,NA,NA,none,hothiphop.parents,hot.parents
2019,1,WCR2019_0675,2,WCR2019_0440,WCR2019_0216,within-group subordinate,within-group subordinate,280,230,50,48,5,278,235,1,99999,6836,8163,6789,0.102199538218496,0,0,NA,NA,none,hothiphop.parents,hot.parents
2019,1,WCR2019_0675,3,WCR2019_0008,WCR2019_0216,within-group subordinate,within-group subordinate,288,241,47,45,5,286,246,1,99999,8093,8163,8027,0.102199538218496,0,0,NA,NA,none,hothiphop.parents,hot.parents
2019,1,WCR2019_0676,1,WCR2019_0223,WCR2019_0641,within-group subordinate,within-group subordinate,365,280,85,52,92,332,372,1,99999,6068,6175,4557,0.0889101338432122,0,0,NA,NA,none,hothiphop.parents,hot.parents
2019,1,WCR2019_0676,2,WCR2019_0223,WCR2019_0087,within-group subordinate,within-group subordinate,369,297,72,52,63,349,360,1,99999,6068,7307,5273,0.0889101338432122,0,0,NA,NA,none,hothiphop.parents,hot.parents
2019,1,WCR2019_0676,3,WCR2019_0223,WCR2019_0073,within-group subordinate,within-group subordinate,391,317,74,52,61,369,378,1,99999,6068,7982,5754,0.0889101338432122,0,0,NA,NA,none,hothiphop.parents,hot.parents
2019,1,WCR2019_0677,1,WCR2019_0223,WCR2019_0641,within-group subordinate,within-group subordinate,268,215,53,38,60,253,275,1,99999,5946,6037,4464,0.113758553274682,0,0,NA,NA,none,hothiphop.parents,hot.parents
2019,1,WCR2019_0677,2,WCR2019_0482,WCR2019_0641,within-group subordinate,within-group subordinate,317,228,89,51,60,279,288,1,99999,8080,6037,5966,0.113758553274682,0,0,NA,NA,none,hothiphop.parents,hot.parents
2019,1,WCR2019_0677,3,WCR2019_0223,WCR2019_0327,within-group subordinate,within-group subordinate,319,277,42,38,18,315,295,1,99999,5946,8037,5863,0.113758553274682,0,0,NA,NA,none,hothiphop.parents,hot.parents
2019,1,WCR2019_0678,1,WCR2019_0223,WCR2019_0641,within-group subordinate,within-group subordinate,354,265,89,59,97,324,362,1,99999,6072,6173,4557,0.0879436013860676,0,0,NA,NA,none,hothiphop.parents,hot.parents
2019,1,WCR2019_0678,2,WCR2019_0223,WCR2019_0087,within-group subordinate,within-group subordinate,361,286,75,59,62,345,348,1,99999,6072,7309,5278,0.0879436013860676,0,0,NA,NA,none,hothiphop.parents,hot.parents
2019,1,WCR2019_0678,3,WCR2019_0126,WCR2019_0641,within-group subordinate,within-group subordinate,361,229,132,135,97,364,326,1,99999,5308,6173,3958,0.0879436013860676,0,0,NA,NA,none,hothiphop.parents,hot.parents
2019,1,WCR2019_0679,1,WCR2019_0223,WCR2019_0641,within-group subordinate,within-group subordinate,333,259,74,43,85,302,344,1,99999,6013,6112,4512,0.0884411196911197,0,0,NA,NA,none,hothiphop.parents,hot.parents
2019,1,WCR2019_0679,2,WCR2019_0223,WCR2019_0087,within-group subordinate,within-group subordinate,343,285,58,43,62,328,347,1,99999,6013,7248,5233,0.0884411196911197,0,0,NA,NA,none,hothiphop.parents,hot.parents
2019,1,WCR2019_0679,3,WCR2019_0223,WCR2019_0073,within-group subordinate,within-group subordinate,359,295,64,43,58,338,353,1,99999,6013,7904,5701,0.0884411196911197,0,0,NA,NA,none,hothiphop.parents,hot.parents
2019,1,WCR2019_0680,1,WCR2019_0223,WCR2019_0641,within-group subordinate,within-group subordinate,371,282,89,60,96,342,378,1,99999,6066,6173,4556,0.0936378856732839,0,0,NA,NA,none,hothiphop.parents,hot.parents
2019,1,WCR2019_0680,2,WCR2019_0223,WCR2019_0087,within-group subordinate,within-group subordinate,402,322,80,60,72,382,394,1,99999,6066,7301,5270,0.0936378856732839,0,0,NA,NA,none,hothiphop.parents,hot.parents
2019,1,WCR2019_0680,3,WCR2019_0126,WCR2019_0641,within-group subordinate,within-group subordinate,406,261,145,148,96,409,357,1,99999,5304,6173,3959,0.0936378856732839,0,0,NA,NA,none,hothiphop.parents,hot.parents
2019,1,WCR2019_0681,1,WCR2019_0223,WCR2019_0641,within-group subordinate,within-group subordinate,257,207,50,55,37,262,244,1,99999,6068,6174,4558,0.134950992110925,0,0,NA,NA,none,hothiphop.parents,hot.parents
2019,1,WCR2019_0681,2,WCR2019_0440,WCR2019_0641,within-group subordinate,within-group subordinate,301,246,55,45,37,291,283,1,99999,6954,6174,5175,0.134950992110925,0,0,NA,NA,none,hothiphop.parents,hot.parents
2019,1,WCR2019_0681,3,WCR2019_0008,WCR2019_0641,within-group subordinate,within-group subordinate,308,272,36,14,37,286,309,1,99999,8230,6174,6088,0.134950992110925,0,0,NA,NA,none,hothiphop.parents,hot.parents
2019,1,WCR2019_0682,1,WCR2019_0223,WCR2019_0641,within-group subordinate,within-group subordinate,255,195,60,69,39,264,234,1,99999,6013,6108,4517,0.125256673511294,0,0,NA,NA,none,hothiphop.parents,hot.parents
2019,1,WCR2019_0682,2,WCR2019_0440,WCR2019_0641,within-group subordinate,within-group subordinate,273,210,63,61,39,271,249,1,99999,6882,6108,5118,0.125256673511294,0,0,NA,NA,none,hothiphop.parents,hot.parents
2019,1,WCR2019_0682,3,WCR2019_0292,WCR2019_0641,within-group subordinate,within-group subordinate,291,244,47,29,39,273,283,1,99999,8243,6108,6082,0.125256673511294,0,0,NA,NA,none,hothiphop.parents,hot.parents
2019,1,WCR2019_0683,1,WCR2019_0223,WCR2019_0641,within-group subordinate,within-group subordinate,316,232,84,53,82,285,314,1,99999,6071,6165,4557,0.0985763847350161,0,0,NA,NA,none,hothiphop.parents,hot.parents
2019,1,WCR2019_0683,2,WCR2019_0076,WCR2019_0641,within-group subordinate,within-group subordinate,341,250,91,53,82,303,332,1,99999,7193,6165,5316,0.0985763847350161,0,0,NA,NA,none,hothiphop.parents,hot.parents
2019,1,WCR2019_0683,3,WCR2019_0223,WCR2019_0327,within-group subordinate,within-group subordinate,347,284,63,53,33,337,317,1,99999,6071,8209,5985,0.0985763847350161,0,0,NA,NA,none,hothiphop.parents,hot.parents
2019,1,WCR2019_0686,1,WCR2019_0223,WCR2019_0592,within-group subordinate,within-group subordinate,262,234,28,26,10,260,244,1,99999,6070,8336,6052,0.162523900573614,0,0,NA,NA,none,hothiphop.parents,hot.parents
2019,1,WCR2019_0686,2,WCR2019_0223,WCR2019_0641,within-group subordinate,within-group subordinate,266,241,25,26,21,267,262,1,99999,6070,6176,4560,0.162523900573614,0,0,NA,NA,none,hothiphop.parents,hot.parents
2019,1,WCR2019_0686,3,WCR2019_0223,WCR2019_0325,within-group subordinate,within-group subordinate,269,242,27,26,8,268,250,1,99999,6070,8317,6036,0.162523900573614,0,0,NA,NA,none,hothiphop.parents,hot.parents
2019,1,WCR2019_0688,1,WCR2019_0532,WCR2019_0327,within-group subordinate,within-group subordinate,284,254,30,8,28,262,282,1,99999,8278,8191,8131,0.0960316508811893,0,0,NA,NA,none,hothiphop.parents,hot.parents
2019,1,WCR2019_0688,2,WCR2019_0532,WCR2019_0122,within-group subordinate,within-group subordinate,289,246,43,8,43,254,289,1,99999,8278,8275,8213,0.0960316508811893,0,0,NA,NA,none,hothiphop.parents,hot.parents
2019,1,WCR2019_0688,3,WCR2019_0532,WCR2019_0475,within-group subordinate,within-group subordinate,300,230,70,8,67,238,297,1,99999,8278,8314,8251,0.0960316508811893,0,0,NA,NA,none,hothiphop.parents,hot.parents
2019,1,WCR2019_0690,1,WCR2019_0223,WCR2019_0641,within-group subordinate,within-group subordinate,363,283,80,52,87,335,370,1,99999,6034,6135,4528,0.0962971868237557,0,0,NA,NA,none,hothiphop.parents,hot.parents
2019,1,WCR2019_0690,2,WCR2019_0126,WCR2019_0641,within-group subordinate,within-group subordinate,395,255,140,153,87,408,342,1,99999,5268,6135,3929,0.0962971868237557,0,0,NA,NA,none,hothiphop.parents,hot.parents
2019,1,WCR2019_0690,3,WCR2019_0223,WCR2019_0087,within-group subordinate,within-group subordinate,411,337,74,52,76,389,413,1,99999,6034,7264,5242,0.0962971868237557,0,0,NA,NA,none,hothiphop.parents,hot.parents
2019,1,WCR2019_0693,1,WCR2019_0223,WCR2019_0641,within-group subordinate,within-group subordinate,238,171,67,58,48,229,219,1,99999,5941,6017,4457,0.134337496938526,0,0,NA,NA,none,hothiphop.parents,hot.parents
2019,1,WCR2019_0693,2,WCR2019_0223,WCR2019_0327,within-group subordinate,within-group subordinate,267,206,61,58,21,264,227,1,99999,5941,8019,5858,0.134337496938526,0,0,NA,NA,none,hothiphop.parents,hot.parents
2019,1,WCR2019_0693,3,WCR2019_0223,WCR2019_0075,within-group subordinate,within-group subordinate,269,205,64,58,33,263,238,1,99999,5941,7631,5515,0.134337496938526,0,0,NA,NA,none,hothiphop.parents,hot.parents
2019,1,WCR2019_0695,1,WCR2019_0223,WCR2019_0641,within-group subordinate,within-group subordinate,304,244,60,33,77,277,321,1,99999,5922,6012,4446,0.0902837489251935,0,0,NA,NA,none,hothiphop.parents,hot.parents
2019,1,WCR2019_0695,2,WCR2019_0223,WCR2019_0087,within-group subordinate,within-group subordinate,322,276,46,33,42,309,318,1,99999,5922,7094,5135,0.0902837489251935,0,0,NA,NA,none,hothiphop.parents,hot.parents
2019,1,WCR2019_0695,3,WCR2019_0223,WCR2019_0327,within-group subordinate,within-group subordinate,325,287,38,33,19,320,306,1,99999,5922,7996,5837,0.0902837489251935,0,0,NA,NA,none,hothiphop.parents,hot.parents
2019,1,WCR2019_0698,1,WCR2019_0337,WCR2019_0405,within-group subordinate,within-group subordinate,17,3,14,11,3,14,6,1,99999,8304,8195,8136,0.174100203276336,0,0,NA,NA,none,hothiphop.parents,hot.parents
2019,1,WCR2019_0698,2,WCR2019_0337,WCR2019_0088,within-group subordinate,within-group subordinate,91,76,15,11,6,87,82,1,99999,8304,7391,7334,0.174100203276336,0,0,NA,NA,none,hothiphop.parents,hot.parents
2019,1,WCR2019_0698,3,WCR2019_0337,WCR2019_0617,within-group subordinate,within-group subordinate,91,56,35,11,24,67,80,1,99999,8304,8337,8278,0.174100203276336,0,0,NA,NA,none,hothiphop.parents,hot.parents
2019,1,WCR2019_0699,1,WCR2019_0585,WCR2019_0087,within-group subordinate,within-group subordinate,298,238,60,12,53,250,291,1,99999,8343,7307,7284,0.0916586998087954,0,0,NA,NA,none,hothiphop.parents,hot.parents
2019,1,WCR2019_0699,2,WCR2019_0585,WCR2019_0327,within-group subordinate,within-group subordinate,309,270,39,12,33,282,303,1,99999,8343,8217,8193,0.0916586998087954,0,0,NA,NA,none,hothiphop.parents,hot.parents
2019,1,WCR2019_0699,3,WCR2019_0585,WCR2019_0641,within-group subordinate,within-group subordinate,313,210,103,12,100,222,310,1,99999,8343,6174,6153,0.0916586998087954,0,0,NA,NA,none,hothiphop.parents,hot.parents
2019,1,WCR2019_0700,1,WCR2019_0585,WCR2019_0087,within-group subordinate,within-group subordinate,293,242,51,7,46,249,288,1,99999,8316,7282,7261,0.0908981892313227,0,0,NA,NA,none,hothiphop.parents,hot.parents
2019,1,WCR2019_0700,2,WCR2019_0585,WCR2019_0327,within-group subordinate,within-group subordinate,296,258,38,7,34,265,292,1,99999,8316,8189,8167,0.0908981892313227,0,0,NA,NA,none,hothiphop.parents,hot.parents
2019,1,WCR2019_0700,3,WCR2019_0585,WCR2019_0641,within-group subordinate,within-group subordinate,299,204,95,7,93,211,297,1,99999,8316,6152,6132,0.0908981892313227,0,0,NA,NA,none,hothiphop.parents,hot.parents
2019,1,WCR2019_0701,1,WCR2019_0223,WCR2019_0641,within-group subordinate,within-group subordinate,358,276,82,48,94,324,370,1,99999,6072,6175,4558,0.0903117907060088,0,0,NA,NA,none,hothiphop.parents,hot.parents
2019,1,WCR2019_0701,2,WCR2019_0223,WCR2019_0087,within-group subordinate,within-group subordinate,370,302,68,48,63,350,365,1,99999,6072,7309,5276,0.0903117907060088,0,0,NA,NA,none,hothiphop.parents,hot.parents
2019,1,WCR2019_0701,3,WCR2019_0126,WCR2019_0641,within-group subordinate,within-group subordinate,374,242,132,125,94,367,336,1,99999,5308,6175,3959,0.0903117907060088,0,0,NA,NA,none,hothiphop.parents,hot.parents
2019,1,WCR2019_0702,1,WCR2019_0318,WCR2019_0088,within-group subordinate,within-group subordinate,83,65,18,4,16,69,81,1,99999,8342,7398,7373,0.0914087704624208,0,0,NA,NA,none,hothiphop.parents,hot.parents
2019,1,WCR2019_0702,2,WCR2019_0318,WCR2019_0039,within-group subordinate,within-group subordinate,88,64,24,4,22,68,86,1,99999,8342,8244,8217,0.0914087704624208,0,0,NA,NA,none,hothiphop.parents,hot.parents
2019,1,WCR2019_0702,3,WCR2019_0318,WCR2019_0031,within-group subordinate,within-group subordinate,88,63,25,4,22,67,85,1,99999,8342,8358,8331,0.0914087704624208,0,0,NA,NA,none,hothiphop.parents,hot.parents
2019,1,WCR2019_0703,1,WCR2019_0223,WCR2019_0641,within-group subordinate,within-group subordinate,312,236,76,53,76,289,312,1,99999,6056,6154,4543,0.135840919980834,0,0,NA,NA,none,hothiphop.parents,hot.parents
2019,1,WCR2019_0703,2,WCR2019_0310,WCR2019_0641,within-group subordinate,within-group subordinate,331,246,85,21,76,267,322,1,99999,8309,6154,6131,0.135840919980834,0,0,NA,NA,none,hothiphop.parents,hot.parents
2019,1,WCR2019_0703,3,WCR2019_0223,WCR2019_0161,within-group subordinate,within-group subordinate,347,290,57,53,35,343,325,1,99999,6056,8216,5963,0.135840919980834,0,0,NA,NA,none,hothiphop.parents,hot.parents
2019,1,WCR2019_0704,1,WCR2019_0223,WCR2019_0641,within-group subordinate,within-group subordinate,370,294,76,45,88,339,382,1,99999,6069,6172,4555,0.0989720296437963,0,0,NA,NA,none,hothiphop.parents,hot.parents
2019,1,WCR2019_0704,2,WCR2019_0126,WCR2019_0641,within-group subordinate,within-group subordinate,385,250,135,138,88,388,338,1,99999,5306,6172,3958,0.0989720296437963,0,0,NA,NA,none,hothiphop.parents,hot.parents
2019,1,WCR2019_0704,3,WCR2019_0223,WCR2019_0087,within-group subordinate,within-group subordinate,389,326,63,45,64,371,390,1,99999,6069,7306,5273,0.0989720296437963,0,0,NA,NA,none,hothiphop.parents,hot.parents
2019,1,WCR2019_0705,1,WCR2019_0223,WCR2019_0641,within-group subordinate,within-group subordinate,358,274,84,51,94,325,368,1,99999,6063,6172,4555,0.0923444976076555,0,0,NA,NA,none,hothiphop.parents,hot.parents
2019,1,WCR2019_0705,2,WCR2019_0223,WCR2019_0087,within-group subordinate,within-group subordinate,382,311,71,51,73,362,384,1,99999,6063,7296,5265,0.0923444976076555,0,0,NA,NA,none,hothiphop.parents,hot.parents
2019,1,WCR2019_0705,3,WCR2019_0126,WCR2019_0641,within-group subordinate,within-group subordinate,386,238,148,157,94,395,332,1,99999,5301,6172,3956,0.0923444976076555,0,0,NA,NA,none,hothiphop.parents,hot.parents
2019,1,WCR2019_0706,1,WCR2019_0223,WCR2019_0641,within-group subordinate,within-group subordinate,345,266,79,52,87,318,353,1,99999,6069,6174,4557,0.107949790794979,0,0,NA,NA,none,hothiphop.parents,hot.parents
2019,1,WCR2019_0706,2,WCR2019_0223,WCR2019_0327,within-group subordinate,within-group subordinate,357,302,55,52,37,354,339,1,99999,6069,8215,5984,0.107949790794979,0,0,NA,NA,none,hothiphop.parents,hot.parents
2019,1,WCR2019_0706,3,WCR2019_0208,WCR2019_0327,within-group subordinate,within-group subordinate,360,285,75,58,37,343,322,1,99999,8273,8215,8127,0.107949790794979,0,0,NA,NA,none,hothiphop.parents,hot.parents
2019,1,WCR2019_0707,1,WCR2019_0223,WCR2019_0641,within-group subordinate,within-group subordinate,359,268,91,62,104,330,372,1,99999,6050,6159,4545,0.0892857142857143,0,0,NA,NA,none,hothiphop.parents,hot.parents
2019,1,WCR2019_0707,2,WCR2019_0223,WCR2019_0087,within-group subordinate,within-group subordinate,375,297,78,62,74,359,371,1,99999,6050,7289,5259,0.0892857142857143,0,0,NA,NA,none,hothiphop.parents,hot.parents
2019,1,WCR2019_0707,3,WCR2019_0223,WCR2019_0073,within-group subordinate,within-group subordinate,393,312,81,62,72,374,384,1,99999,6050,7954,5732,0.0892857142857143,0,0,NA,NA,none,hothiphop.parents,hot.parents
2019,1,WCR2019_0708,1,WCR2019_0585,WCR2019_0327,within-group subordinate,within-group subordinate,280,245,35,9,32,254,277,1,99999,8346,8221,8196,0.0936454849498328,0,0,NA,NA,none,hothiphop.parents,hot.parents
2019,1,WCR2019_0708,2,WCR2019_0585,WCR2019_0641,within-group subordinate,within-group subordinate,283,188,95,9,93,197,281,1,99999,8346,6175,6153,0.0936454849498328,0,0,NA,NA,none,hothiphop.parents,hot.parents
2019,1,WCR2019_0708,3,WCR2019_0585,WCR2019_0161,within-group subordinate,within-group subordinate,286,235,51,9,47,244,282,1,99999,8346,8238,8212,0.0936454849498328,0,0,NA,NA,none,hothiphop.parents,hot.parents
2019,1,WCR2019_0709,1,WCR2019_0435,WCR2019_0327,within-group subordinate,within-group subordinate,253,217,36,4,33,221,250,1,99999,8249,8134,8104,0.0997464074387151,0,0,NA,NA,none,hothiphop.parents,hot.parents
2019,1,WCR2019_0709,2,WCR2019_0435,WCR2019_0161,within-group subordinate,within-group subordinate,269,230,39,4,35,234,265,1,99999,8249,8150,8118,0.0997464074387151,0,0,NA,NA,none,hothiphop.parents,hot.parents
2019,1,WCR2019_0709,3,WCR2019_0435,WCR2019_0122,within-group subordinate,within-group subordinate,276,225,51,4,48,229,273,1,99999,8249,8216,8184,0.0997464074387151,0,0,NA,NA,none,hothiphop.parents,hot.parents
2019,1,WCR2019_0710,1,WCR2019_0223,WCR2019_0641,within-group subordinate,within-group subordinate,343,253,90,56,97,309,350,1,99999,6075,6179,4563,0.0881299259613088,0,0,NA,NA,none,hothiphop.parents,hot.parents
2019,1,WCR2019_0710,2,WCR2019_0223,WCR2019_0087,within-group subordinate,within-group subordinate,364,294,70,56,61,350,355,1,99999,6075,7312,5279,0.0881299259613088,0,0,NA,NA,none,hothiphop.parents,hot.parents
2019,1,WCR2019_0710,3,WCR2019_0126,WCR2019_0641,within-group subordinate,within-group subordinate,377,238,139,138,97,376,335,1,99999,5314,6179,3964,0.0881299259613088,0,0,NA,NA,none,hothiphop.parents,hot.parents
2019,1,WCR2019_0711,1,WCR2019_0223,WCR2019_0641,within-group subordinate,within-group subordinate,350,275,75,44,88,319,363,1,99999,6065,6166,4550,0.101208278502213,0,0,NA,NA,none,hothiphop.parents,hot.parents
2019,1,WCR2019_0711,2,WCR2019_0223,WCR2019_0327,within-group subordinate,within-group subordinate,378,327,51,44,37,371,364,1,99999,6065,8208,5979,0.101208278502213,0,0,NA,NA,none,hothiphop.parents,hot.parents
2019,1,WCR2019_0711,3,WCR2019_0223,WCR2019_0452,within-group subordinate,within-group subordinate,388,314,74,44,70,358,384,1,99999,6065,8316,6034,0.101208278502213,0,0,NA,NA,none,hothiphop.parents,hot.parents
2019,1,WCR2019_0712,1,WCR2019_0223,WCR2019_0641,within-group subordinate,within-group subordinate,366,276,90,64,94,340,370,1,99999,6074,6178,4561,0.0898124925355309,0,0,NA,NA,none,hothiphop.parents,hot.parents
2019,1,WCR2019_0712,2,WCR2019_0126,WCR2019_0641,within-group subordinate,within-group subordinate,375,238,137,144,94,382,332,1,99999,5313,6178,3963,0.0898124925355309,0,0,NA,NA,none,hothiphop.parents,hot.parents
2019,1,WCR2019_0712,3,WCR2019_0223,WCR2019_0087,within-group subordinate,within-group subordinate,397,318,79,64,65,382,383,1,99999,6074,7310,5277,0.0898124925355309,0,0,NA,NA,none,hothiphop.parents,hot.parents
2019,1,WCR2019_0714,1,WCR2019_0585,WCR2019_0122,within-group subordinate,within-group subordinate,265,216,49,3,47,219,263,1,99999,8174,8133,8108,0.0874496889864618,0,0,NA,NA,none,hothiphop.parents,hot.parents
2019,1,WCR2019_0714,2,WCR2019_0585,WCR2019_0327,within-group subordinate,within-group subordinate,274,241,33,3,31,244,272,1,99999,8174,8050,8026,0.0874496889864618,0,0,NA,NA,none,hothiphop.parents,hot.parents
2019,1,WCR2019_0714,3,WCR2019_0585,WCR2019_0087,within-group subordinate,within-group subordinate,279,230,49,3,47,233,277,1,99999,8174,7153,7130,0.0874496889864618,0,0,NA,NA,none,hothiphop.parents,hot.parents
2019,1,WCR2019_0716,1,WCR2019_0223,WCR2019_0641,within-group subordinate,within-group subordinate,307,238,69,52,71,290,309,1,99999,6071,6170,4557,0.136010517509263,0,0,NA,NA,none,hothiphop.parents,hot.parents
2019,1,WCR2019_0716,2,WCR2019_0223,WCR2019_0327,within-group subordinate,within-group subordinate,355,295,60,52,37,347,332,1,99999,6071,8216,5985,0.136010517509263,0,0,NA,NA,none,hothiphop.parents,hot.parents
2019,1,WCR2019_0716,3,WCR2019_0223,WCR2019_0161,within-group subordinate,within-group subordinate,356,297,59,52,49,349,346,1,99999,6071,8233,5976,0.136010517509263,0,0,NA,NA,none,hothiphop.parents,hot.parents
2019,1,WCR2019_0717,1,WCR2019_0223,WCR2019_0641,within-group subordinate,within-group subordinate,248,206,42,28,36,234,242,1,99999,6072,6171,4557,0.157385277246654,0,0,NA,NA,none,hothiphop.parents,hot.parents
2019,1,WCR2019_0717,2,WCR2019_0223,WCR2019_0592,within-group subordinate,within-group subordinate,251,220,31,28,7,248,227,1,99999,6072,8337,6054,0.157385277246654,0,0,NA,NA,none,hothiphop.parents,hot.parents
2019,1,WCR2019_0717,3,WCR2019_0223,WCR2019_0325,within-group subordinate,within-group subordinate,254,224,30,28,5,252,229,1,99999,6072,8317,6038,0.157385277246654,0,0,NA,NA,none,hothiphop.parents,hot.parents
2019,1,WCR2019_0718,1,WCR2019_0223,WCR2019_0641,within-group subordinate,within-group subordinate,334,257,77,53,82,310,339,1,99999,6059,6168,4551,0.106843742522134,0,0,NA,NA,none,hothiphop.parents,hot.parents
2019,1,WCR2019_0718,2,WCR2019_0223,WCR2019_0087,within-group subordinate,within-group subordinate,368,300,68,53,52,353,352,1,99999,6059,7300,5267,0.106843742522134,0,0,NA,NA,none,hothiphop.parents,hot.parents
2019,1,WCR2019_0718,3,WCR2019_0126,WCR2019_0641,within-group subordinate,within-group subordinate,372,241,131,136,82,377,323,1,99999,5304,6168,3956,0.106843742522134,0,0,NA,NA,none,hothiphop.parents,hot.parents
2019,1,WCR2019_0719,1,WCR2019_0194,WCR2019_0327,within-group subordinate,within-group subordinate,178,160,18,2,17,162,177,1,99999,7829,7743,7697,0.099492385786802,0,0,NA,NA,none,hothiphop.parents,hot.parents
2019,1,WCR2019_0719,2,WCR2019_0194,WCR2019_0122,within-group subordinate,within-group subordinate,183,151,32,2,30,153,181,1,99999,7829,7817,7766,0.099492385786802,0,0,NA,NA,none,hothiphop.parents,hot.parents
2019,1,WCR2019_0719,3,WCR2019_0194,WCR2019_0161,within-group subordinate,within-group subordinate,197,164,33,2,31,166,195,1,99999,7829,7754,7705,0.099492385786802,0,0,NA,NA,none,hothiphop.parents,hot.parents
2019,1,WCR2019_0720,1,WCR2019_0223,WCR2019_0087,within-group subordinate,within-group subordinate,340,275,65,46,57,321,332,1,99999,6037,7288,5258,0.0959068539190974,0,0,NA,NA,none,hothiphop.parents,hot.parents
2019,1,WCR2019_0720,2,WCR2019_0223,WCR2019_0641,within-group subordinate,within-group subordinate,342,257,85,46,99,303,356,1,99999,6037,6147,4533,0.0959068539190974,0,0,NA,NA,none,hothiphop.parents,hot.parents
2019,1,WCR2019_0720,3,WCR2019_0223,WCR2019_0327,within-group subordinate,within-group subordinate,356,303,53,46,36,349,339,1,99999,6037,8181,5952,0.0959068539190974,0,0,NA,NA,none,hothiphop.parents,hot.parents
2019,1,WCR2019_0721,1,WCR2019_0223,WCR2019_0641,within-group subordinate,within-group subordinate,358,286,72,53,72,339,358,1,99999,6055,6161,4546,0.107292539815591,0,0,NA,NA,none,hothiphop.parents,hot.parents
2019,1,WCR2019_0721,2,WCR2019_0223,WCR2019_0279,within-group subordinate,within-group subordinate,362,291,71,53,40,344,331,1,99999,6055,8264,5999,0.107292539815591,0,0,NA,NA,none,hothiphop.parents,hot.parents
2019,1,WCR2019_0721,3,WCR2019_0223,WCR2019_0087,within-group subordinate,within-group subordinate,378,310,68,53,50,363,360,1,99999,6055,7291,5259,0.107292539815591,0,0,NA,NA,none,hothiphop.parents,hot.parents
2019,1,WCR2019_0722,1,WCR2019_0008,WCR2019_0405,within-group subordinate,within-group subordinate,223,192,31,32,2,224,194,1,99999,8205,8174,8039,0.112203308559099,0,0,NA,NA,none,hothiphop.parents,hot.parents
2019,1,WCR2019_0722,2,WCR2019_0008,WCR2019_0641,within-group subordinate,within-group subordinate,232,169,63,32,51,201,220,1,99999,8205,6154,6067,0.112203308559099,0,0,NA,NA,none,hothiphop.parents,hot.parents
2019,1,WCR2019_0722,3,WCR2019_0008,WCR2019_0088,within-group subordinate,within-group subordinate,233,203,30,32,14,235,217,1,99999,8205,7377,7262,0.112203308559099,0,0,NA,NA,none,hothiphop.parents,hot.parents
2019,1,WCR2019_0723,1,WCR2019_0223,WCR2019_0641,within-group subordinate,within-group subordinate,377,294,83,50,96,344,390,1,99999,6067,6174,4556,0.113182741723437,0,0,NA,NA,none,hothiphop.parents,hot.parents
2019,1,WCR2019_0723,2,WCR2019_0126,WCR2019_0641,within-group subordinate,within-group subordinate,410,274,136,130,96,404,370,1,99999,5307,6174,3958,0.113182741723437,0,0,NA,NA,none,hothiphop.parents,hot.parents
2019,1,WCR2019_0723,3,WCR2019_0223,WCR2019_0122,within-group subordinate,within-group subordinate,411,356,55,50,32,406,388,1,99999,6067,8301,6017,0.113182741723437,0,0,NA,NA,none,hothiphop.parents,hot.parents
2019,1,WCR2019_0724,1,WCR2019_0532,WCR2019_0122,within-group subordinate,within-group subordinate,286,238,48,5,47,243,285,1,99999,8298,8298,8234,0.0939854119335167,0,0,NA,NA,none,hothiphop.parents,hot.parents
2019,1,WCR2019_0724,2,WCR2019_0532,WCR2019_0327,within-group subordinate,within-group subordinate,287,254,33,5,34,259,288,1,99999,8298,8212,8150,0.0939854119335167,0,0,NA,NA,none,hothiphop.parents,hot.parents
2019,1,WCR2019_0724,3,WCR2019_0532,WCR2019_0230,within-group subordinate,within-group subordinate,291,231,60,5,61,236,292,1,99999,8298,8193,8135,0.0939854119335167,0,0,NA,NA,none,hothiphop.parents,hot.parents
2019,1,WCR2019_0725,1,WCR2019_0223,WCR2019_0461,within-group subordinate,within-group subordinate,262,209,53,51,6,260,215,1,99999,6062,8309,6040,0.106240268295604,0,0,NA,NA,none,hothiphop.parents,hot.parents
2019,1,WCR2019_0725,2,WCR2019_0440,WCR2019_0461,within-group subordinate,within-group subordinate,281,222,59,56,6,278,228,1,99999,6947,8309,6919,0.106240268295604,0,0,NA,NA,none,hothiphop.parents,hot.parents
2019,1,WCR2019_0725,3,WCR2019_0008,WCR2019_0461,within-group subordinate,within-group subordinate,302,245,57,52,6,297,251,1,99999,8214,8309,8175,0.106240268295604,0,0,NA,NA,none,hothiphop.parents,hot.parents
2019,1,WCR2019_0726,1,WCR2019_0223,WCR2019_0641,within-group subordinate,within-group subordinate,372,282,90,62,94,344,376,1,99999,6044,6145,4541,0.102437852768104,0,0,NA,NA,none,hothiphop.parents,hot.parents
2019,1,WCR2019_0726,2,WCR2019_0223,WCR2019_0327,within-group subordinate,within-group subordinate,415,346,69,62,43,408,389,1,99999,6044,8177,5958,0.102437852768104,0,0,NA,NA,none,hothiphop.parents,hot.parents
2019,1,WCR2019_0726,3,WCR2019_0223,WCR2019_0087,within-group subordinate,within-group subordinate,415,334,81,62,66,396,400,1,99999,6044,7273,5253,0.102437852768104,0,0,NA,NA,none,hothiphop.parents,hot.parents
2019,1,WCR2019_0727,1,WCR2019_0532,WCR2019_0327,within-group subordinate,within-group subordinate,273,247,26,3,26,250,273,1,99999,8287,8201,8139,0.0956657088122605,0,0,NA,NA,none,hothiphop.parents,hot.parents
2019,1,WCR2019_0727,2,WCR2019_0532,WCR2019_0122,within-group subordinate,within-group subordinate,278,242,36,3,36,245,278,1,99999,8287,8286,8222,0.0956657088122605,0,0,NA,NA,none,hothiphop.parents,hot.parents
2019,1,WCR2019_0727,3,WCR2019_0532,WCR2019_0641,within-group subordinate,within-group subordinate,295,213,82,3,83,216,296,1,99999,8287,6159,6107,0.0956657088122605,0,0,NA,NA,none,hothiphop.parents,hot.parents
2019,1,WCR2019_0728,1,WCR2019_0223,WCR2019_0516,within-group subordinate,within-group subordinate,231,170,61,59,8,229,178,1,99999,6073,8321,6044,0.0936566718432684,0,0,NA,NA,none,hothiphop.parents,hot.parents
2019,1,WCR2019_0728,2,WCR2019_0440,WCR2019_0516,within-group subordinate,within-group subordinate,270,216,54,52,8,268,224,1,99999,6958,8321,6918,0.0936566718432684,0,0,NA,NA,none,hothiphop.parents,hot.parents
2019,1,WCR2019_0728,3,WCR2019_0076,WCR2019_0516,within-group subordinate,within-group subordinate,275,217,58,56,8,273,225,1,99999,7203,8321,7159,0.0936566718432684,0,0,NA,NA,none,hothiphop.parents,hot.parents
2019,1,WCR2019_0729,1,WCR2019_0223,WCR2019_0641,within-group subordinate,within-group subordinate,336,242,94,67,91,309,333,1,99999,5983,6078,4493,0.101746301236963,0,0,NA,NA,none,hothiphop.parents,hot.parents
2019,1,WCR2019_0729,2,WCR2019_0219,WCR2019_0641,within-group subordinate,within-group subordinate,348,243,105,46,91,289,334,1,99999,7475,6078,5537,0.101746301236963,0,0,NA,NA,none,hothiphop.parents,hot.parents
2019,1,WCR2019_0729,3,WCR2019_0219,WCR2019_0327,within-group subordinate,within-group subordinate,378,310,68,46,43,356,353,1,99999,7475,8097,7357,0.101746301236963,0,0,NA,NA,none,hothiphop.parents,hot.parents
2019,1,WCR2019_0730,1,WCR2019_0223,WCR2019_0641,within-group subordinate,within-group subordinate,285,228,57,48,54,276,282,1,99999,5954,6061,4473,0.128042843232717,0,0,NA,NA,none,hothiphop.parents,hot.parents
2019,1,WCR2019_0730,2,WCR2019_0208,WCR2019_0327,within-group subordinate,within-group subordinate,316,236,80,61,36,297,272,1,99999,8124,8066,7978,0.128042843232717,0,0,NA,NA,none,hothiphop.parents,hot.parents
2019,1,WCR2019_0730,3,WCR2019_0223,WCR2019_0088,within-group subordinate,within-group subordinate,317,251,66,48,62,299,313,1,99999,5954,7266,5249,0.128042843232717,0,0,NA,NA,none,hothiphop.parents,hot.parents
2019,1,WCR2019_0731,1,WCR2019_0223,WCR2019_0641,within-group subordinate,within-group subordinate,283,211,72,54,55,265,266,1,99999,6069,6169,4559,0.118421052631579,0,0,NA,NA,none,hothiphop.parents,hot.parents
2019,1,WCR2019_0731,2,WCR2019_0223,WCR2019_0327,within-group subordinate,within-group subordinate,317,259,58,54,23,313,282,1,99999,6069,8209,5983,0.118421052631579,0,0,NA,NA,none,hothiphop.parents,hot.parents
2019,1,WCR2019_0731,3,WCR2019_0223,WCR2019_0075,within-group subordinate,within-group subordinate,324,258,66,54,38,312,296,1,99999,6069,7814,5637,0.118421052631579,0,0,NA,NA,none,hothiphop.parents,hot.parents
2019,1,WCR2019_0733,1,WCR2019_0223,WCR2019_0516,within-group subordinate,within-group subordinate,260,211,49,45,5,256,216,1,99999,6073,8320,6043,0.1,0,0,NA,NA,none,hothiphop.parents,hot.parents
2019,1,WCR2019_0733,2,WCR2019_0440,WCR2019_0516,within-group subordinate,within-group subordinate,292,240,52,48,5,288,245,1,99999,6956,8320,6916,0.1,0,0,NA,NA,none,hothiphop.parents,hot.parents
2019,1,WCR2019_0733,3,WCR2019_0191,WCR2019_0516,within-group subordinate,within-group subordinate,296,227,69,64,5,291,232,1,99999,7071,8320,7030,0.1,0,0,NA,NA,none,hothiphop.parents,hot.parents
2019,1,WCR2019_0734,1,WCR2019_0223,WCR2019_0461,within-group subordinate,within-group subordinate,257,204,53,50,7,254,211,1,99999,6051,8307,6031,0.0995805871779509,0,0,NA,NA,none,hothiphop.parents,hot.parents
2019,1,WCR2019_0734,2,WCR2019_0008,WCR2019_0461,within-group subordinate,within-group subordinate,271,222,49,43,7,265,229,1,99999,8209,8307,8172,0.0995805871779509,0,0,NA,NA,none,hothiphop.parents,hot.parents
2019,1,WCR2019_0734,3,WCR2019_0076,WCR2019_0461,within-group subordinate,within-group subordinate,298,246,52,49,7,295,253,1,99999,7184,8307,7152,0.0995805871779509,0,0,NA,NA,none,hothiphop.parents,hot.parents
2019,1,WCR2019_0735,1,WCR2019_0337,WCR2019_0405,within-group subordinate,within-group subordinate,27,10,17,13,5,23,15,1,99999,8276,8170,8112,0.173146148308135,0,0,NA,NA,none,hothiphop.parents,hot.parents
2019,1,WCR2019_0735,2,WCR2019_0337,WCR2019_0088,within-group subordinate,within-group subordinate,98,85,13,13,6,98,91,1,99999,8276,7362,7306,0.173146148308135,0,0,NA,NA,none,hothiphop.parents,hot.parents
2019,1,WCR2019_0735,3,WCR2019_0337,WCR2019_0617,within-group subordinate,within-group subordinate,102,69,33,13,21,82,90,1,99999,8276,8308,8250,0.173146148308135,0,0,NA,NA,none,hothiphop.parents,hot.parents
2019,1,WCR2019_0736,1,WCR2019_0292,WCR2019_0363,within-group subordinate,within-group subordinate,232,193,39,10,31,203,224,1,99999,8320,8322,8287,0.155696505505026,0,0,NA,NA,none,hothiphop.parents,hot.parents
2019,1,WCR2019_0736,2,WCR2019_0595,WCR2019_0363,within-group subordinate,within-group subordinate,243,197,46,20,31,217,228,1,99999,8342,8322,8308,0.155696505505026,0,0,NA,NA,none,hothiphop.parents,hot.parents
2019,1,WCR2019_0736,3,WCR2019_0399,WCR2019_0363,within-group subordinate,within-group subordinate,273,216,57,33,31,249,247,1,99999,8339,8322,8306,0.155696505505026,0,0,NA,NA,none,hothiphop.parents,hot.parents
2019,1,WCR2019_0737,1,WCR2019_0223,WCR2019_0461,within-group subordinate,within-group subordinate,269,223,46,44,5,267,228,1,99999,5991,8223,5970,0.109174534011135,0,0,NA,NA,none,hothiphop.parents,hot.parents
2019,1,WCR2019_0737,2,WCR2019_0008,WCR2019_0461,within-group subordinate,within-group subordinate,271,233,38,35,5,268,238,1,99999,8130,8223,8092,0.109174534011135,0,0,NA,NA,none,hothiphop.parents,hot.parents
2019,1,WCR2019_0737,3,WCR2019_0440,WCR2019_0461,within-group subordinate,within-group subordinate,301,249,52,50,5,299,254,1,99999,6858,8223,6831,0.109174534011135,0,0,NA,NA,none,hothiphop.parents,hot.parents
2019,1,WCR2019_0738,1,WCR2019_0223,WCR2019_0641,within-group subordinate,within-group subordinate,229,213,16,18,9,231,222,1,99999,6064,6168,4557,0.186550197439272,0,0,NA,NA,none,hothiphop.parents,hot.parents
2019,1,WCR2019_0738,2,WCR2019_0223,WCR2019_0075,within-group subordinate,within-group subordinate,268,252,16,18,6,270,258,1,99999,6064,7811,5632,0.186550197439272,0,0,NA,NA,none,hothiphop.parents,hot.parents
2019,1,WCR2019_0738,3,WCR2019_0223,WCR2019_0088,within-group subordinate,within-group subordinate,270,256,14,18,5,274,261,1,99999,6064,7386,5345,0.186550197439272,0,0,NA,NA,none,hothiphop.parents,hot.parents
2019,1,WCR2019_0739,1,WCR2019_0223,WCR2019_0641,within-group subordinate,within-group subordinate,337,262,75,54,83,316,345,1,99999,6070,6173,4557,0.116304087975137,0,0,NA,NA,none,hothiphop.parents,hot.parents
2019,1,WCR2019_0739,2,WCR2019_0223,WCR2019_0327,within-group subordinate,within-group subordinate,360,302,58,54,35,356,337,1,99999,6070,8216,5984,0.116304087975137,0,0,NA,NA,none,hothiphop.parents,hot.parents
2019,1,WCR2019_0739,3,WCR2019_0208,WCR2019_0327,within-group subordinate,within-group subordinate,360,287,73,51,35,338,322,1,99999,8275,8216,8129,0.116304087975137,0,0,NA,NA,none,hothiphop.parents,hot.parents
2019,1,WCR2019_0740,1,WCR2019_0223,WCR2019_0641,within-group subordinate,within-group subordinate,352,261,91,69,109,330,370,1,99999,6062,6166,4550,0.0951412158927717,0,0,NA,NA,none,hothiphop.parents,hot.parents
2019,1,WCR2019_0740,2,WCR2019_0126,WCR2019_0641,within-group subordinate,within-group subordinate,365,221,144,152,109,373,330,1,99999,5298,6166,3953,0.0951412158927717,0,0,NA,NA,none,hothiphop.parents,hot.parents
2019,1,WCR2019_0740,3,WCR2019_0223,WCR2019_0087,within-group subordinate,within-group subordinate,388,304,84,69,75,373,379,1,99999,6062,7294,5265,0.0951412158927717,0,0,NA,NA,none,hothiphop.parents,hot.parents
2019,1,WCR2019_0741,1,WCR2019_0223,WCR2019_0641,within-group subordinate,within-group subordinate,342,278,64,40,70,318,348,1,99999,6073,6175,4561,0.120549581839904,0,0,NA,NA,none,hothiphop.parents,hot.parents
2019,1,WCR2019_0741,2,WCR2019_0208,WCR2019_0641,within-group subordinate,within-group subordinate,347,264,83,37,70,301,334,1,99999,8279,6175,6114,0.120549581839904,0,0,NA,NA,none,hothiphop.parents,hot.parents
2019,1,WCR2019_0741,3,WCR2019_0208,WCR2019_0327,within-group subordinate,within-group subordinate,354,300,54,37,26,337,326,1,99999,8279,8219,8132,0.120549581839904,0,0,NA,NA,none,hothiphop.parents,hot.parents
2019,1,WCR2019_0742,1,WCR2019_0223,WCR2019_0641,within-group subordinate,within-group subordinate,311,236,75,56,81,292,317,1,99999,5973,6069,4481,0.0966958211856171,0,0,NA,NA,none,hothiphop.parents,hot.parents
2019,1,WCR2019_0742,2,WCR2019_0223,WCR2019_0087,within-group subordinate,within-group subordinate,344,273,71,56,75,329,348,1,99999,5973,7209,5202,0.0966958211856171,0,0,NA,NA,none,hothiphop.parents,hot.parents
2019,1,WCR2019_0742,3,WCR2019_0223,WCR2019_0327,within-group subordinate,within-group subordinate,363,298,65,56,57,354,355,1,99999,5973,8083,5889,0.0966958211856171,0,0,NA,NA,none,hothiphop.parents,hot.parents
2019,1,WCR2019_0744,1,WCR2019_0223,WCR2019_0641,within-group subordinate,within-group subordinate,277,241,36,30,28,271,269,1,99999,6069,6174,4555,0.169274877553458,0,0,NA,NA,none,hothiphop.parents,hot.parents
2019,1,WCR2019_0744,2,WCR2019_0223,WCR2019_0592,within-group subordinate,within-group subordinate,303,267,36,30,11,297,278,1,99999,6069,8338,6050,0.169274877553458,0,0,NA,NA,none,hothiphop.parents,hot.parents
2019,1,WCR2019_0744,3,WCR2019_0223,WCR2019_0088,within-group subordinate,within-group subordinate,307,272,35,30,26,302,298,1,99999,6069,7399,5349,0.169274877553458,0,0,NA,NA,none,hothiphop.parents,hot.parents
2019,1,WCR2019_0745,1,WCR2019_0223,WCR2019_0641,within-group subordinate,within-group subordinate,293,229,64,46,56,275,285,1,99999,6063,6167,4556,0.13964341270791,0,0,NA,NA,none,hothiphop.parents,hot.parents
2019,1,WCR2019_0745,2,WCR2019_0310,WCR2019_0641,within-group subordinate,within-group subordinate,329,264,65,25,56,289,320,1,99999,8317,6167,6142,0.13964341270791,0,0,NA,NA,none,hothiphop.parents,hot.parents
2019,1,WCR2019_0745,3,WCR2019_0223,WCR2019_0161,within-group subordinate,within-group subordinate,330,281,49,46,36,327,317,1,99999,6063,8223,5968,0.13964341270791,0,0,NA,NA,none,hothiphop.parents,hot.parents
2019,1,WCR2019_0786,1,WCR2019_0223,WCR2019_0216,within-group subordinate,within-group subordinate,262,207,55,53,8,260,215,1,99999,6065,8296,6029,0.0999760822769672,0,0,NA,NA,none,hothiphop.parents,hot.parents
2019,1,WCR2019_0786,2,WCR2019_0440,WCR2019_0216,within-group subordinate,within-group subordinate,281,224,57,54,8,278,232,1,99999,6948,8296,6901,0.0999760822769672,0,0,NA,NA,none,hothiphop.parents,hot.parents
2019,1,WCR2019_0786,3,WCR2019_0008,WCR2019_0216,within-group subordinate,within-group subordinate,289,236,53,50,8,286,244,1,99999,8226,8296,8160,0.0999760822769672,0,0,NA,NA,none,hothiphop.parents,hot.parents
2019,1,WCR2019_0787,1,WCR2019_0223,WCR2019_0461,within-group subordinate,within-group subordinate,250,186,64,62,7,248,193,1,99999,6054,8307,6032,0.101353779801126,0,0,NA,NA,none,hothiphop.parents,hot.parents
2019,1,WCR2019_0787,2,WCR2019_0440,WCR2019_0461,within-group subordinate,within-group subordinate,272,207,65,64,7,271,214,1,99999,6938,8307,6910,0.101353779801126,0,0,NA,NA,none,hothiphop.parents,hot.parents
2019,1,WCR2019_0787,3,WCR2019_0191,WCR2019_0461,within-group subordinate,within-group subordinate,273,180,93,90,7,270,187,1,99999,7053,8307,7023,0.101353779801126,0,0,NA,NA,none,hothiphop.parents,hot.parents
2019,1,WCR2019_0789,1,WCR2019_0421,WCR2019_0548,within-group subordinate,within-group subordinate,13,1,12,6,6,7,7,1,99999,8339,8315,8298,0.12683977503889,0,0,NA,NA,none,hothiphop.parents,hot.parents
2019,1,WCR2019_0789,2,WCR2019_0008,WCR2019_0548,within-group subordinate,within-group subordinate,202,168,34,32,6,200,174,1,99999,8221,8315,8179,0.12683977503889,0,0,NA,NA,none,hothiphop.parents,hot.parents
2019,1,WCR2019_0789,3,WCR2019_0256,WCR2019_0548,within-group subordinate,within-group subordinate,219,181,38,35,6,216,187,1,99999,8294,8315,8252,0.12683977503889,0,0,NA,NA,none,hothiphop.parents,hot.parents
2019,1,WCR2019_0790,1,WCR2019_0223,WCR2019_0641,within-group subordinate,within-group subordinate,359,280,79,50,96,330,376,1,99999,6065,6173,4555,0.0900286944045911,0,0,NA,NA,none,hothiphop.parents,hot.parents
2019,1,WCR2019_0790,2,WCR2019_0223,WCR2019_0087,within-group subordinate,within-group subordinate,361,297,64,50,60,347,357,1,99999,6065,7309,5275,0.0900286944045911,0,0,NA,NA,none,hothiphop.parents,hot.parents
2019,1,WCR2019_0790,3,WCR2019_0126,WCR2019_0641,within-group subordinate,within-group subordinate,371,240,131,132,96,372,336,1,99999,5306,6173,3959,0.0900286944045911,0,0,NA,NA,none,hothiphop.parents,hot.parents
2019,1,WCR2019_0791,1,WCR2019_0008,WCR2019_0150,within-group subordinate,within-group subordinate,246,213,33,28,6,241,219,1,99999,8223,8336,8200,0.125717703349282,0,0,NA,NA,none,hothiphop.parents,hot.parents
2019,1,WCR2019_0791,2,WCR2019_0196,WCR2019_0150,within-group subordinate,within-group subordinate,269,220,49,43,6,263,226,1,99999,8302,8336,8278,0.125717703349282,0,0,NA,NA,none,hothiphop.parents,hot.parents
2019,1,WCR2019_0791,3,WCR2019_0267,WCR2019_0150,within-group subordinate,within-group subordinate,269,219,50,45,6,264,225,1,99999,8299,8336,8276,0.125717703349282,0,0,NA,NA,none,hothiphop.parents,hot.parents
2019,1,WCR2019_0792,1,WCR2019_0585,WCR2019_0327,within-group subordinate,within-group subordinate,268,228,40,8,34,236,262,1,99999,8326,8200,8176,0.088252903843851,0,0,NA,NA,none,hothiphop.parents,hot.parents
2019,1,WCR2019_0792,2,WCR2019_0585,WCR2019_0087,within-group subordinate,within-group subordinate,269,207,62,8,56,215,263,1,99999,8326,7292,7269,0.088252903843851,0,0,NA,NA,none,hothiphop.parents,hot.parents
2019,1,WCR2019_0792,3,WCR2019_0585,WCR2019_0641,within-group subordinate,within-group subordinate,292,186,106,8,103,194,289,1,99999,8326,6161,6140,0.088252903843851,0,0,NA,NA,none,hothiphop.parents,hot.parents
2019,1,WCR2019_0793,1,WCR2019_0223,WCR2019_0641,within-group subordinate,within-group subordinate,342,296,46,22,57,318,353,1,99999,6054,6159,4545,0.168762726074979,0,0,NA,NA,none,hothiphop.parents,hot.parents
2019,1,WCR2019_0793,2,WCR2019_0482,WCR2019_0641,within-group subordinate,within-group subordinate,344,281,63,14,57,295,338,1,99999,8245,6159,6089,0.168762726074979,0,0,NA,NA,none,hothiphop.parents,hot.parents
2019,1,WCR2019_0793,3,WCR2019_0482,WCR2019_0327,within-group subordinate,within-group subordinate,352,324,28,14,16,338,340,1,99999,8245,8200,8097,0.168762726074979,0,0,NA,NA,none,hothiphop.parents,hot.parents
2019,1,WCR2019_0794,1,WCR2019_0223,WCR2019_0641,within-group subordinate,within-group subordinate,346,271,75,45,83,316,354,1,99999,6069,6172,4557,0.0928870292887029,0,0,NA,NA,none,hothiphop.parents,hot.parents
2019,1,WCR2019_0794,2,WCR2019_0223,WCR2019_0087,within-group subordinate,within-group subordinate,350,289,61,45,51,334,340,1,99999,6069,7307,5276,0.0928870292887029,0,0,NA,NA,none,hothiphop.parents,hot.parents
2019,1,WCR2019_0794,3,WCR2019_0223,WCR2019_0073,within-group subordinate,within-group subordinate,361,301,60,45,50,346,351,1,99999,6069,7977,5753,0.0928870292887029,0,0,NA,NA,none,hothiphop.parents,hot.parents
2019,1,WCR2019_0795,1,WCR2019_0223,WCR2019_0216,within-group subordinate,within-group subordinate,252,189,63,60,7,249,196,1,99999,6061,8294,6027,0.0983606557377049,0,0,NA,NA,none,hothiphop.parents,hot.parents
2019,1,WCR2019_0795,2,WCR2019_0440,WCR2019_0216,within-group subordinate,within-group subordinate,263,198,65,62,7,260,205,1,99999,6947,8294,6903,0.0983606557377049,0,0,NA,NA,none,hothiphop.parents,hot.parents
2019,1,WCR2019_0795,3,WCR2019_0076,WCR2019_0216,within-group subordinate,within-group subordinate,273,218,55,51,7,269,225,1,99999,7201,8294,7141,0.0983606557377049,0,0,NA,NA,none,hothiphop.parents,hot.parents
2019,1,WCR2019_0796,1,WCR2019_0223,WCR2019_0641,within-group subordinate,within-group subordinate,347,263,84,52,95,315,358,1,99999,6067,6168,4555,0.0936490850376749,0,0,NA,NA,none,hothiphop.parents,hot.parents
2019,1,WCR2019_0796,2,WCR2019_0126,WCR2019_0641,within-group subordinate,within-group subordinate,369,234,135,140,95,374,329,1,99999,5307,6168,3958,0.0936490850376749,0,0,NA,NA,none,hothiphop.parents,hot.parents
2019,1,WCR2019_0796,3,WCR2019_0223,WCR2019_0087,within-group subordinate,within-group subordinate,371,307,64,52,56,359,363,1,99999,6067,7297,5269,0.0936490850376749,0,0,NA,NA,none,hothiphop.parents,hot.parents
2019,1,WCR2019_0797,1,WCR2019_0223,WCR2019_0641,within-group subordinate,within-group subordinate,259,216,43,26,50,242,266,1,99999,6066,6168,4554,0.135526315789474,0,0,NA,NA,none,hothiphop.parents,hot.parents
2019,1,WCR2019_0797,2,WCR2019_0223,WCR2019_0327,within-group subordinate,within-group subordinate,313,283,30,26,14,309,297,1,99999,6066,8209,5980,0.135526315789474,0,0,NA,NA,none,hothiphop.parents,hot.parents
2019,1,WCR2019_0797,3,WCR2019_0440,WCR2019_0641,within-group subordinate,within-group subordinate,320,261,59,39,50,300,311,1,99999,6947,6168,5169,0.135526315789474,0,0,NA,NA,none,hothiphop.parents,hot.parents
2019,1,WCR2019_0798,1,WCR2019_0223,WCR2019_0087,within-group subordinate,within-group subordinate,352,287,65,54,54,341,341,1,99999,6065,7294,5267,0.0849485522852357,0,0,NA,NA,none,hothiphop.parents,hot.parents
2019,1,WCR2019_0798,2,WCR2019_0223,WCR2019_0641,within-group subordinate,within-group subordinate,355,256,99,54,112,310,368,1,99999,6065,6172,4556,0.0849485522852357,0,0,NA,NA,none,hothiphop.parents,hot.parents
2019,1,WCR2019_0798,3,WCR2019_0223,WCR2019_0073,within-group subordinate,within-group subordinate,366,291,75,54,68,345,359,1,99999,6065,7967,5746,0.0849485522852357,0,0,NA,NA,none,hothiphop.parents,hot.parents
2019,1,WCR2019_0799,1,WCR2019_0223,WCR2019_0641,within-group subordinate,within-group subordinate,281,230,51,38,62,268,292,1,99999,6052,6156,4545,0.126782504493709,0,0,NA,NA,none,hothiphop.parents,hot.parents
2019,1,WCR2019_0799,2,WCR2019_0482,WCR2019_0641,within-group subordinate,within-group subordinate,311,222,89,56,62,278,284,1,99999,8241,6156,6086,0.126782504493709,0,0,NA,NA,none,hothiphop.parents,hot.parents
2019,1,WCR2019_0799,3,WCR2019_0223,WCR2019_0327,within-group subordinate,within-group subordinate,337,294,43,38,37,332,331,1,99999,6052,8194,5966,0.126782504493709,0,0,NA,NA,none,hothiphop.parents,hot.parents
2019,1,WCR2019_0800,1,WCR2019_0223,WCR2019_0475,within-group subordinate,within-group subordinate,237,199,38,33,8,232,207,1,99999,6065,8335,6054,0.13084559263246,0,0,NA,NA,none,hothiphop.parents,hot.parents
2019,1,WCR2019_0800,2,WCR2019_0440,WCR2019_0475,within-group subordinate,within-group subordinate,277,221,56,53,8,274,229,1,99999,6949,8335,6928,0.13084559263246,0,0,NA,NA,none,hothiphop.parents,hot.parents
2019,1,WCR2019_0800,3,WCR2019_0008,WCR2019_0475,within-group subordinate,within-group subordinate,290,251,39,34,8,285,259,1,99999,8224,8335,8198,0.13084559263246,0,0,NA,NA,none,hothiphop.parents,hot.parents
2019,1,WCR2019_0801,1,WCR2019_0420,WCR2019_0405,within-group subordinate,within-group subordinate,6,5,1,1,0,6,5,1,99999,8324,8173,8158,0.0239836910900588,0,0,NA,NA,none,hothiphop.parents,hot.parents
2019,1,WCR2019_0801,2,WCR2019_0474,WCR2019_0405,within-group subordinate,within-group subordinate,60,48,12,13,0,61,48,1,99999,8003,8173,7855,0.0239836910900588,0,0,NA,NA,none,hothiphop.parents,hot.parents
2019,1,WCR2019_0801,3,WCR2019_0521,WCR2019_0405,within-group subordinate,within-group subordinate,64,42,22,23,0,65,42,1,99999,8267,8173,8106,0.0239836910900588,0,0,NA,NA,none,hothiphop.parents,hot.parents
2019,1,WCR2019_0802,1,WCR2019_0409,WCR2019_0405,within-group subordinate,within-group subordinate,107,64,43,24,29,88,93,1,99999,8268,8136,8106,0.0251837570791662,0,0,NA,NA,none,hothiphop.parents,hot.parents
2019,1,WCR2019_0802,2,WCR2019_0409,WCR2019_0634,within-group subordinate,within-group subordinate,107,64,43,24,29,88,93,1,99999,8268,8262,8232,0.0251837570791662,0,0,NA,NA,none,hothiphop.parents,hot.parents
2019,1,WCR2019_0802,3,WCR2019_0064,WCR2019_0634,within-group subordinate,within-group subordinate,110,71,39,25,29,96,100,1,99999,7252,8262,7229,0.0251837570791662,0,0,NA,NA,none,hothiphop.parents,hot.parents
2019,1,WCR2019_0803,1,WCR2019_0420,WCR2019_0325,within-group subordinate,within-group subordinate,13,5,8,5,4,10,9,1,99999,8136,8107,8094,0.057531894013739,0,0,NA,NA,none,hothiphop.parents,hot.parents
2019,1,WCR2019_0803,2,WCR2019_0474,WCR2019_0325,within-group subordinate,within-group subordinate,56,40,16,14,4,54,44,1,99999,7833,8107,7791,0.057531894013739,0,0,NA,NA,none,hothiphop.parents,hot.parents
2019,1,WCR2019_0803,3,WCR2019_0420,WCR2019_0592,within-group subordinate,within-group subordinate,56,24,32,5,28,29,52,1,99999,8136,8121,8107,0.057531894013739,0,0,NA,NA,none,hothiphop.parents,hot.parents
2019,1,WCR2019_0804,1,WCR2019_0223,WCR2019_0641,within-group subordinate,within-group subordinate,274,228,46,37,49,265,277,1,99999,6069,6172,4557,0.132679894812336,0,0,NA,NA,none,hothiphop.parents,hot.parents
2019,1,WCR2019_0804,2,WCR2019_0482,WCR2019_0327,within-group subordinate,within-group subordinate,303,258,45,29,22,287,280,1,99999,8262,8216,8113,0.132679894812336,0,0,NA,NA,none,hothiphop.parents,hot.parents
2019,1,WCR2019_0804,3,WCR2019_0482,WCR2019_0641,within-group subordinate,within-group subordinate,308,242,66,29,49,271,291,1,99999,8262,6172,6101,0.132679894812336,0,0,NA,NA,none,hothiphop.parents,hot.parents
2019,1,WCR2019_0805,1,WCR2019_0337,WCR2019_0405,within-group subordinate,within-group subordinate,22,7,15,11,4,18,11,1,99999,8267,8158,8100,0.176936936936937,0,0,NA,NA,none,hothiphop.parents,hot.parents
2019,1,WCR2019_0805,2,WCR2019_0337,WCR2019_0088,within-group subordinate,within-group subordinate,99,86,13,11,5,97,91,1,99999,8267,7368,7312,0.176936936936937,0,0,NA,NA,none,hothiphop.parents,hot.parents
2019,1,WCR2019_0805,3,WCR2019_0337,WCR2019_0388,within-group subordinate,within-group subordinate,100,61,39,11,28,72,89,1,99999,8267,8301,8243,0.176936936936937,0,0,NA,NA,none,hothiphop.parents,hot.parents
2019,1,WCR2019_0807,1,WCR2019_0223,WCR2019_0641,within-group subordinate,within-group subordinate,373,285,88,54,95,339,380,1,99999,6050,6145,4541,0.0908545367258761,0,0,NA,NA,none,hothiphop.parents,hot.parents
2019,1,WCR2019_0807,2,WCR2019_0223,WCR2019_0087,within-group subordinate,within-group subordinate,379,307,72,54,66,361,373,1,99999,6050,7270,5253,0.0908545367258761,0,0,NA,NA,none,hothiphop.parents,hot.parents
2019,1,WCR2019_0807,3,WCR2019_0223,WCR2019_0073,within-group subordinate,within-group subordinate,397,322,75,54,66,376,388,1,99999,6050,7941,5731,0.0908545367258761,0,0,NA,NA,none,hothiphop.parents,hot.parents
2019,1,WCR2019_0811,1,WCR2019_0223,WCR2019_0641,within-group subordinate,within-group subordinate,273,233,40,35,39,268,272,1,99999,6056,6164,4549,0.140924329501916,0,0,NA,NA,none,hothiphop.parents,hot.parents
2019,1,WCR2019_0811,2,WCR2019_0223,WCR2019_0088,within-group subordinate,within-group subordinate,301,249,52,35,51,284,300,1,99999,6056,7378,5333,0.140924329501916,0,0,NA,NA,none,hothiphop.parents,hot.parents
2019,1,WCR2019_0811,3,WCR2019_0440,WCR2019_0641,within-group subordinate,within-group subordinate,302,252,50,29,39,281,291,1,99999,6945,6164,5169,0.140924329501916,0,0,NA,NA,none,hothiphop.parents,hot.parents
2019,1,WCR2019_0818,1,WCR2019_0409,WCR2019_0327,within-group subordinate,within-group subordinate,194,134,60,32,38,166,172,1,99999,8322,8202,8172,0.0650065844606728,0,0,NA,NA,none,hothiphop.parents,hot.parents
2019,1,WCR2019_0818,2,WCR2019_0409,WCR2019_0075,within-group subordinate,within-group subordinate,196,140,56,32,35,172,175,1,99999,8322,7805,7777,0.0650065844606728,0,0,NA,NA,none,hothiphop.parents,hot.parents
2019,1,WCR2019_0818,3,WCR2019_0409,WCR2019_0122,within-group subordinate,within-group subordinate,197,142,55,32,32,174,174,1,99999,8322,8288,8257,0.0650065844606728,0,0,NA,NA,none,hothiphop.parents,hot.parents
2019,1,WCR2019_0820,1,WCR2019_0474,WCR2019_0047,within-group subordinate,within-group subordinate,62,46,16,11,5,57,51,1,99999,8023,8353,8015,0.0997488338715465,0,0,NA,NA,none,hothiphop.parents,hot.parents
2019,1,WCR2019_0820,2,WCR2019_0547,WCR2019_0047,within-group subordinate,within-group subordinate,63,49,14,9,5,58,54,1,99999,8319,8353,8311,0.0997488338715465,0,0,NA,NA,none,hothiphop.parents,hot.parents
2019,1,WCR2019_0820,3,WCR2019_0011,WCR2019_0047,within-group subordinate,within-group subordinate,67,51,16,11,5,62,56,1,99999,8347,8353,8340,0.0997488338715465,0,0,NA,NA,none,hothiphop.parents,hot.parents
2019,1,WCR2019_0821,1,WCR2019_0223,WCR2019_0641,within-group subordinate,within-group subordinate,359,268,91,64,104,332,372,1,99999,6068,6171,4557,0.0904089930638603,0,0,NA,NA,none,hothiphop.parents,hot.parents
2019,1,WCR2019_0821,2,WCR2019_0223,WCR2019_0087,within-group subordinate,within-group subordinate,390,309,81,64,76,373,385,1,99999,6068,7304,5275,0.0904089930638603,0,0,NA,NA,none,hothiphop.parents,hot.parents
2019,1,WCR2019_0821,3,WCR2019_0223,WCR2019_0639,within-group subordinate,within-group subordinate,396,310,86,64,66,374,376,1,99999,6068,8321,6044,0.0904089930638603,0,0,NA,NA,none,hothiphop.parents,hot.parents
2019,1,WCR2019_0824,1,WCR2019_0223,WCR2019_0641,within-group subordinate,within-group subordinate,305,239,66,68,66,307,305,1,99999,6061,6166,4552,0.126720114873759,0,0,NA,NA,none,hothiphop.parents,hot.parents
2019,1,WCR2019_0824,2,WCR2019_0267,WCR2019_0327,within-group subordinate,within-group subordinate,336,299,37,20,26,319,325,1,99999,8296,8206,8148,0.126720114873759,0,0,NA,NA,none,hothiphop.parents,hot.parents
2019,1,WCR2019_0824,3,WCR2019_0223,WCR2019_0327,within-group subordinate,within-group subordinate,350,279,71,68,26,347,305,1,99999,6061,8206,5975,0.126720114873759,0,0,NA,NA,none,hothiphop.parents,hot.parents
2019,1,WCR2019_0825,1,WCR2019_0223,WCR2019_0516,within-group subordinate,within-group subordinate,268,214,54,52,6,266,220,1,99999,6067,8310,6037,0.100478468899522,0,0,NA,NA,none,hothiphop.parents,hot.parents
2019,1,WCR2019_0825,2,WCR2019_0440,WCR2019_0516,within-group subordinate,within-group subordinate,287,237,50,48,6,285,243,1,99999,6952,8310,6911,0.100478468899522,0,0,NA,NA,none,hothiphop.parents,hot.parents
2019,1,WCR2019_0825,3,WCR2019_0076,WCR2019_0516,within-group subordinate,within-group subordinate,292,242,50,49,6,291,248,1,99999,7195,8310,7151,0.100478468899522,0,0,NA,NA,none,hothiphop.parents,hot.parents
2019,1,WCR2019_0826,1,WCR2019_0223,WCR2019_0641,within-group subordinate,within-group subordinate,363,272,91,49,97,321,369,1,99999,6039,6144,4531,0.0893050054015124,0,0,NA,NA,none,hothiphop.parents,hot.parents
2019,1,WCR2019_0826,2,WCR2019_0223,WCR2019_0087,within-group subordinate,within-group subordinate,369,300,69,49,59,349,359,1,99999,6039,7283,5255,0.0893050054015124,0,0,NA,NA,none,hothiphop.parents,hot.parents
2019,1,WCR2019_0826,3,WCR2019_0126,WCR2019_0641,within-group subordinate,within-group subordinate,385,245,140,135,97,380,342,1,99999,5287,6144,3941,0.0893050054015124,0,0,NA,NA,none,hothiphop.parents,hot.parents
2019,1,WCR2019_0827,1,WCR2019_0474,WCR2019_0516,within-group subordinate,within-group subordinate,73,56,17,10,8,66,64,1,99999,8037,8327,7988,0.173928614062313,0,0,NA,NA,none,hothiphop.parents,hot.parents
2019,1,WCR2019_0827,2,WCR2019_0505,WCR2019_0516,within-group subordinate,within-group subordinate,86,53,33,25,8,78,61,1,99999,8316,8327,8267,0.173928614062313,0,0,NA,NA,none,hothiphop.parents,hot.parents
2019,1,WCR2019_0827,3,WCR2019_0345,WCR2019_0516,within-group subordinate,within-group subordinate,87,74,13,7,8,81,82,1,99999,8309,8327,8259,0.173928614062313,0,0,NA,NA,none,hothiphop.parents,hot.parents
2019,1,WCR2019_0829,1,WCR2019_0223,WCR2019_0641,within-group subordinate,within-group subordinate,344,260,84,56,91,316,351,1,99999,6063,6170,4553,0.0981939959335008,0,0,NA,NA,none,hothiphop.parents,hot.parents
2019,1,WCR2019_0829,2,WCR2019_0076,WCR2019_0641,within-group subordinate,within-group subordinate,372,274,98,63,91,337,365,1,99999,7195,6170,5320,0.0981939959335008,0,0,NA,NA,none,hothiphop.parents,hot.parents
2019,1,WCR2019_0829,3,WCR2019_0126,WCR2019_0641,within-group subordinate,within-group subordinate,377,243,134,139,91,382,334,1,99999,5302,6170,3956,0.0981939959335008,0,0,NA,NA,none,hothiphop.parents,hot.parents
2019,1,WCR2019_0831,1,WCR2019_0223,WCR2019_0641,within-group subordinate,within-group subordinate,280,231,49,41,54,272,285,1,99999,6070,6173,4559,0.147058823529412,0,0,NA,NA,none,hothiphop.parents,hot.parents
2019,1,WCR2019_0831,2,WCR2019_0429,WCR2019_0641,within-group subordinate,within-group subordinate,333,258,75,54,54,312,312,1,99999,8328,6173,6146,0.147058823529412,0,0,NA,NA,none,hothiphop.parents,hot.parents
2019,1,WCR2019_0831,3,WCR2019_0440,WCR2019_0641,within-group subordinate,within-group subordinate,338,275,63,47,54,322,329,1,99999,6953,6173,5174,0.147058823529412,0,0,NA,NA,none,hothiphop.parents,hot.parents
2019,1,WCR2019_0832,1,WCR2019_0524,WCR2019_0451,within-group subordinate,within-group subordinate,22,7,15,10,7,17,14,1,99999,8300,8319,8264,0.128306403351287,0,0,NA,NA,none,hothiphop.parents,hot.parents
2019,1,WCR2019_0832,2,WCR2019_0223,WCR2019_0451,within-group subordinate,within-group subordinate,244,193,51,50,7,243,200,1,99999,6058,8319,6037,0.128306403351287,0,0,NA,NA,none,hothiphop.parents,hot.parents
2019,1,WCR2019_0832,3,WCR2019_0524,WCR2019_0327,within-group subordinate,within-group subordinate,252,226,26,10,23,236,249,1,99999,8300,8204,8152,0.128306403351287,0,0,NA,NA,none,hothiphop.parents,hot.parents
2019,1,WCR2019_0833,1,WCR2019_0223,WCR2019_0641,within-group subordinate,within-group subordinate,314,256,58,47,60,303,316,1,99999,6061,6159,4552,0.139417894358606,0,0,NA,NA,none,hothiphop.parents,hot.parents
2019,1,WCR2019_0833,2,WCR2019_0223,WCR2019_0075,within-group subordinate,within-group subordinate,351,295,56,47,39,342,334,1,99999,6061,7806,5632,0.139417894358606,0,0,NA,NA,none,hothiphop.parents,hot.parents
2019,1,WCR2019_0833,3,WCR2019_0223,WCR2019_0327,within-group subordinate,within-group subordinate,355,304,51,47,23,351,327,1,99999,6061,8201,5977,0.139417894358606,0,0,NA,NA,none,hothiphop.parents,hot.parents
2019,1,WCR2019_0834,1,WCR2019_0223,WCR2019_0641,within-group subordinate,within-group subordinate,382,284,98,57,110,341,394,1,99999,6065,6172,4556,0.0994739359158297,0,0,NA,NA,none,hothiphop.parents,hot.parents
2019,1,WCR2019_0834,2,WCR2019_0126,WCR2019_0641,within-group subordinate,within-group subordinate,408,263,145,143,110,406,373,1,99999,5306,6172,3957,0.0994739359158297,0,0,NA,NA,none,hothiphop.parents,hot.parents
2019,1,WCR2019_0834,3,WCR2019_0223,WCR2019_0087,within-group subordinate,within-group subordinate,413,338,75,57,64,395,402,1,99999,6065,7304,5270,0.0994739359158297,0,0,NA,NA,none,hothiphop.parents,hot.parents
2019,1,WCR2019_0836,1,WCR2019_0223,WCR2019_0641,within-group subordinate,within-group subordinate,218,196,22,19,15,215,211,1,99999,6011,6111,4511,0.158981168517624,0,0,NA,NA,none,hothiphop.parents,hot.parents
2019,1,WCR2019_0836,2,WCR2019_0223,WCR2019_0206,within-group subordinate,within-group subordinate,242,217,25,19,16,236,233,1,99999,6011,8214,5964,0.158981168517624,0,0,NA,NA,none,hothiphop.parents,hot.parents
2019,1,WCR2019_0836,3,WCR2019_0008,WCR2019_0641,within-group subordinate,within-group subordinate,244,228,16,6,15,234,243,1,99999,8149,6111,6026,0.158981168517624,0,0,NA,NA,none,hothiphop.parents,hot.parents
2019,1,WCR2019_0837,1,WCR2019_0223,WCR2019_0641,within-group subordinate,within-group subordinate,381,302,79,52,86,354,388,1,99999,6070,6175,4561,0.0992585505859842,0,0,NA,NA,none,hothiphop.parents,hot.parents
2019,1,WCR2019_0837,2,WCR2019_0223,WCR2019_0087,within-group subordinate,within-group subordinate,406,334,72,52,65,386,399,1,99999,6070,7302,5274,0.0992585505859842,0,0,NA,NA,none,hothiphop.parents,hot.parents
2019,1,WCR2019_0837,3,WCR2019_0126,WCR2019_0641,within-group subordinate,within-group subordinate,420,289,131,138,86,427,375,1,99999,5306,6175,3961,0.0992585505859842,0,0,NA,NA,none,hothiphop.parents,hot.parents
2019,1,WCR2019_0838,1,WCR2019_0223,WCR2019_0641,within-group subordinate,within-group subordinate,311,239,72,57,64,296,303,1,99999,6027,6140,4530,0.134150739271547,0,0,NA,NA,none,hothiphop.parents,hot.parents
2019,1,WCR2019_0838,2,WCR2019_0429,WCR2019_0327,within-group subordinate,within-group subordinate,323,270,53,34,28,304,298,1,99999,8284,8171,8136,0.134150739271547,0,0,NA,NA,none,hothiphop.parents,hot.parents
2019,1,WCR2019_0838,3,WCR2019_0429,WCR2019_0122,within-group subordinate,within-group subordinate,338,284,54,34,32,318,316,1,99999,8284,8254,8219,0.134150739271547,0,0,NA,NA,none,hothiphop.parents,hot.parents
2019,1,WCR2019_0839,1,WCR2019_0223,WCR2019_0641,within-group subordinate,within-group subordinate,296,241,55,44,53,285,294,1,99999,6074,6179,4560,0.127387774594078,0,0,NA,NA,none,hothiphop.parents,hot.parents
2019,1,WCR2019_0839,2,WCR2019_0223,WCR2019_0075,within-group subordinate,within-group subordinate,317,271,46,44,44,315,315,1,99999,6074,7832,5644,0.127387774594078,0,0,NA,NA,none,hothiphop.parents,hot.parents
2019,1,WCR2019_0839,3,WCR2019_0223,WCR2019_0122,within-group subordinate,within-group subordinate,327,282,45,44,23,326,305,1,99999,6074,8310,6024,0.127387774594078,0,0,NA,NA,none,hothiphop.parents,hot.parents
2019,1,WCR2019_0840,1,WCR2019_0008,WCR2019_0279,within-group subordinate,within-group subordinate,295,233,62,60,6,293,239,1,99999,8213,8264,8128,0.102766798418972,0,0,NA,NA,none,hothiphop.parents,hot.parents
2019,1,WCR2019_0840,2,WCR2019_0223,WCR2019_0279,within-group subordinate,within-group subordinate,297,232,65,62,6,294,238,1,99999,6050,8264,5996,0.102766798418972,0,0,NA,NA,none,hothiphop.parents,hot.parents
2019,1,WCR2019_0840,3,WCR2019_0196,WCR2019_0279,within-group subordinate,within-group subordinate,300,237,63,59,6,296,243,1,99999,8291,8264,8207,0.102766798418972,0,0,NA,NA,none,hothiphop.parents,hot.parents
2019,1,WCR2019_0841,1,WCR2019_0223,WCR2019_0461,within-group subordinate,within-group subordinate,254,189,65,61,7,250,196,1,99999,6058,8317,6037,0.0988511249401628,0,0,NA,NA,none,hothiphop.parents,hot.parents
2019,1,WCR2019_0841,2,WCR2019_0440,WCR2019_0461,within-group subordinate,within-group subordinate,277,209,68,64,7,273,216,1,99999,6946,8317,6919,0.0988511249401628,0,0,NA,NA,none,hothiphop.parents,hot.parents
2019,1,WCR2019_0841,3,WCR2019_0008,WCR2019_0461,within-group subordinate,within-group subordinate,294,234,60,56,7,290,241,1,99999,8220,8317,8182,0.0988511249401628,0,0,NA,NA,none,hothiphop.parents,hot.parents
2019,1,WCR2019_0842,1,WCR2019_0223,WCR2019_0641,within-group subordinate,within-group subordinate,333,257,76,42,79,299,336,1,99999,5981,6087,4492,0.0927610040014551,0,0,NA,NA,none,hothiphop.parents,hot.parents
2019,1,WCR2019_0842,2,WCR2019_0223,WCR2019_0087,within-group subordinate,within-group subordinate,345,290,55,42,50,332,340,1,99999,5981,7217,5207,0.0927610040014551,0,0,NA,NA,none,hothiphop.parents,hot.parents
2019,1,WCR2019_0842,3,WCR2019_0223,WCR2019_0327,within-group subordinate,within-group subordinate,351,304,47,42,21,346,325,1,99999,5981,8098,5896,0.0927610040014551,0,0,NA,NA,none,hothiphop.parents,hot.parents
2019,1,WCR2019_0844,1,WCR2019_0585,WCR2019_0641,within-group subordinate,within-group subordinate,255,168,87,7,86,175,254,1,99999,8196,6057,6035,0.089394307954269,0,0,NA,NA,none,hothiphop.parents,hot.parents
2019,1,WCR2019_0844,2,WCR2019_0585,WCR2019_0122,within-group subordinate,within-group subordinate,271,224,47,7,42,231,266,1,99999,8196,8157,8131,0.089394307954269,0,0,NA,NA,none,hothiphop.parents,hot.parents
2019,1,WCR2019_0844,3,WCR2019_0585,WCR2019_0327,within-group subordinate,within-group subordinate,276,240,36,7,31,247,271,1,99999,8196,8071,8046,0.089394307954269,0,0,NA,NA,none,hothiphop.parents,hot.parents
2019,1,WCR2019_0845,1,WCR2019_0223,WCR2019_0641,within-group subordinate,within-group subordinate,274,212,62,47,62,259,274,1,99999,6066,6174,4559,0.123998565108215,0,0,NA,NA,none,hothiphop.parents,hot.parents
2019,1,WCR2019_0845,2,WCR2019_0333,WCR2019_0327,within-group subordinate,within-group subordinate,287,256,31,6,26,262,282,1,99999,8333,8212,8184,0.123998565108215,0,0,NA,NA,none,hothiphop.parents,hot.parents
2019,1,WCR2019_0845,3,WCR2019_0333,WCR2019_0641,within-group subordinate,within-group subordinate,289,223,66,6,62,229,285,1,99999,8333,6174,6153,0.123998565108215,0,0,NA,NA,none,hothiphop.parents,hot.parents
2019,1,WCR2019_0847,1,WCR2019_0333,WCR2019_0461,within-group subordinate,within-group subordinate,125,104,21,16,7,120,111,1,99999,8293,8284,8254,0.15811606391926,0,0,NA,NA,none,hothiphop.parents,hot.parents
2019,1,WCR2019_0847,2,WCR2019_0263,WCR2019_0461,within-group subordinate,within-group subordinate,126,105,21,15,7,120,112,1,99999,8270,8284,8232,0.15811606391926,0,0,NA,NA,none,hothiphop.parents,hot.parents
2019,1,WCR2019_0847,3,WCR2019_0166,WCR2019_0461,within-group subordinate,within-group subordinate,128,104,24,18,7,122,111,1,99999,8313,8284,8274,0.15811606391926,0,0,NA,NA,none,hothiphop.parents,hot.parents
2019,1,WCR2019_0848,1,WCR2019_0008,WCR2019_0519,within-group subordinate,within-group subordinate,239,221,18,12,9,233,230,1,99999,8215,8304,8172,0.137724550898204,0,0,NA,NA,none,hothiphop.parents,hot.parents
2019,1,WCR2019_0848,2,WCR2019_0223,WCR2019_0519,within-group subordinate,within-group subordinate,249,171,78,77,9,248,180,1,99999,6058,8304,6030,0.137724550898204,0,0,NA,NA,none,hothiphop.parents,hot.parents
2019,1,WCR2019_0848,3,WCR2019_0488,WCR2019_0519,within-group subordinate,within-group subordinate,250,230,20,17,9,247,239,1,99999,8312,8304,8267,0.137724550898204,0,0,NA,NA,none,hothiphop.parents,hot.parents
2019,1,WCR2019_0849,1,WCR2019_0008,WCR2019_0014,within-group subordinate,within-group subordinate,177,154,23,15,11,169,165,1,99999,8225,8339,8202,0.123654628079407,0,0,NA,NA,none,hothiphop.parents,hot.parents
2019,1,WCR2019_0849,2,WCR2019_0441,WCR2019_0014,within-group subordinate,within-group subordinate,178,151,27,21,11,172,162,1,99999,8340,8339,8318,0.123654628079407,0,0,NA,NA,none,hothiphop.parents,hot.parents
2019,1,WCR2019_0849,3,WCR2019_0345,WCR2019_0014,within-group subordinate,within-group subordinate,188,152,36,26,11,178,163,1,99999,8294,8339,8271,0.123654628079407,0,0,NA,NA,none,hothiphop.parents,hot.parents
2019,1,WCR2019_0851,1,WCR2019_0223,WCR2019_0641,within-group subordinate,within-group subordinate,376,291,85,54,93,345,384,1,99999,6073,6173,4558,0.108363201911589,0,0,NA,NA,none,hothiphop.parents,hot.parents
2019,1,WCR2019_0851,2,WCR2019_0208,WCR2019_0327,within-group subordinate,within-group subordinate,385,321,64,49,34,370,355,1,99999,8278,8219,8131,0.108363201911589,0,0,NA,NA,none,hothiphop.parents,hot.parents
2019,1,WCR2019_0851,3,WCR2019_0208,WCR2019_0641,within-group subordinate,within-group subordinate,398,290,108,49,93,339,383,1,99999,8278,6173,6111,0.108363201911589,0,0,NA,NA,none,hothiphop.parents,hot.parents
2019,1,WCR2019_0853,1,WCR2019_0223,WCR2019_0641,within-group subordinate,within-group subordinate,295,238,57,39,62,277,300,1,99999,6065,6171,4555,0.126315789473684,0,0,NA,NA,none,hothiphop.parents,hot.parents
2019,1,WCR2019_0853,2,WCR2019_0440,WCR2019_0327,within-group subordinate,within-group subordinate,299,257,42,36,21,293,278,1,99999,6950,8209,6841,0.126315789473684,0,0,NA,NA,none,hothiphop.parents,hot.parents
2019,1,WCR2019_0853,3,WCR2019_0440,WCR2019_0641,within-group subordinate,within-group subordinate,304,238,66,36,62,274,300,1,99999,6950,6171,5173,0.126315789473684,0,0,NA,NA,none,hothiphop.parents,hot.parents
2019,1,WCR2019_0854,1,WCR2019_0223,WCR2019_0641,within-group subordinate,within-group subordinate,338,259,79,53,84,312,343,1,99999,6058,6162,4548,0.0920627319525919,0,0,NA,NA,none,hothiphop.parents,hot.parents
2019,1,WCR2019_0854,2,WCR2019_0223,WCR2019_0087,within-group subordinate,within-group subordinate,369,299,70,53,64,352,363,1,99999,6058,7300,5268,0.0920627319525919,0,0,NA,NA,none,hothiphop.parents,hot.parents
2019,1,WCR2019_0854,3,WCR2019_0126,WCR2019_0641,within-group subordinate,within-group subordinate,373,243,130,140,84,383,327,1,99999,5301,6162,3954,0.0920627319525919,0,0,NA,NA,none,hothiphop.parents,hot.parents
2019,1,WCR2019_0855,1,WCR2019_0223,WCR2019_0641,within-group subordinate,within-group subordinate,277,203,74,67,42,270,245,1,99999,5973,6075,4486,0.130645944633317,0,0,NA,NA,none,hothiphop.parents,hot.parents
2019,1,WCR2019_0855,2,WCR2019_0223,WCR2019_0327,within-group subordinate,within-group subordinate,306,235,71,67,15,302,250,1,99999,5973,8088,5889,0.130645944633317,0,0,NA,NA,none,hothiphop.parents,hot.parents
2019,1,WCR2019_0855,3,WCR2019_0223,WCR2019_0519,within-group subordinate,within-group subordinate,310,236,74,67,22,303,258,1,99999,5973,8190,5945,0.130645944633317,0,0,NA,NA,none,hothiphop.parents,hot.parents
2019,1,WCR2019_0856,1,WCR2019_0223,WCR2019_0641,within-group subordinate,within-group subordinate,258,165,93,87,54,252,219,1,99999,6023,6124,4524,0.107310610622667,0,0,NA,NA,none,hothiphop.parents,hot.parents
2019,1,WCR2019_0856,2,WCR2019_0267,WCR2019_0641,within-group subordinate,within-group subordinate,265,205,60,21,54,226,259,1,99999,8243,6124,6086,0.107310610622667,0,0,NA,NA,none,hothiphop.parents,hot.parents
2019,1,WCR2019_0856,3,WCR2019_0267,WCR2019_0327,within-group subordinate,within-group subordinate,286,251,35,21,25,272,276,1,99999,8243,8155,8098,0.107310610622667,0,0,NA,NA,none,hothiphop.parents,hot.parents
2019,1,WCR2019_0857,1,WCR2019_0223,WCR2019_0641,within-group subordinate,within-group subordinate,324,263,61,38,72,301,335,1,99999,6071,6165,4558,0.127438075864545,0,0,NA,NA,none,hothiphop.parents,hot.parents
2019,1,WCR2019_0857,2,WCR2019_0223,WCR2019_0327,within-group subordinate,within-group subordinate,364,323,41,38,26,361,349,1,99999,6071,8206,5985,0.127438075864545,0,0,NA,NA,none,hothiphop.parents,hot.parents
2019,1,WCR2019_0857,3,WCR2019_0223,WCR2019_0122,within-group subordinate,within-group subordinate,368,320,48,38,35,358,355,1,99999,6071,8291,6021,0.127438075864545,0,0,NA,NA,none,hothiphop.parents,hot.parents
2019,1,WCR2019_0858,1,WCR2019_0223,WCR2019_0641,within-group subordinate,within-group subordinate,382,284,98,77,110,361,394,1,99999,6065,6166,4554,0.0969363331737673,0,0,NA,NA,none,hothiphop.parents,hot.parents
2019,1,WCR2019_0858,2,WCR2019_0223,WCR2019_0087,within-group subordinate,within-group subordinate,398,309,89,77,76,386,385,1,99999,6065,7292,5267,0.0969363331737673,0,0,NA,NA,none,hothiphop.parents,hot.parents
2019,1,WCR2019_0858,3,WCR2019_0126,WCR2019_0641,within-group subordinate,within-group subordinate,401,259,142,144,110,403,369,1,99999,5301,6166,3953,0.0969363331737673,0,0,NA,NA,none,hothiphop.parents,hot.parents
2019,1,WCR2019_0860,1,WCR2019_0223,WCR2019_0641,within-group subordinate,within-group subordinate,254,153,101,116,74,269,227,1,99999,6050,6154,4545,0.113963531669866,0,0,NA,NA,none,hothiphop.parents,hot.parents
2019,1,WCR2019_0860,2,WCR2019_0008,WCR2019_0641,within-group subordinate,within-group subordinate,307,225,82,33,74,258,299,1,99999,8200,6154,6067,0.113963531669866,0,0,NA,NA,none,hothiphop.parents,hot.parents
2019,1,WCR2019_0860,3,WCR2019_0223,WCR2019_0122,within-group subordinate,within-group subordinate,308,190,118,116,20,306,210,1,99999,6050,8271,6001,0.113963531669866,0,0,NA,NA,none,hothiphop.parents,hot.parents
2019,1,WCR2019_0861,1,WCR2019_0223,WCR2019_0641,within-group subordinate,within-group subordinate,314,225,89,59,89,284,314,1,99999,6056,6156,4542,0.119281437125748,0,0,NA,NA,none,hothiphop.parents,hot.parents
2019,1,WCR2019_0861,2,WCR2019_0223,WCR2019_0075,within-group subordinate,within-group subordinate,334,264,70,59,62,323,326,1,99999,6056,7810,5628,0.119281437125748,0,0,NA,NA,none,hothiphop.parents,hot.parents
2019,1,WCR2019_0861,3,WCR2019_0223,WCR2019_0327,within-group subordinate,within-group subordinate,344,274,70,59,51,333,325,1,99999,6056,8199,5970,0.119281437125748,0,0,NA,NA,none,hothiphop.parents,hot.parents
2019,1,WCR2019_0862,1,WCR2019_0223,WCR2019_0641,within-group subordinate,within-group subordinate,322,252,70,44,77,296,329,1,99999,6068,6166,4556,0.108386170594569,0,0,NA,NA,none,hothiphop.parents,hot.parents
2019,1,WCR2019_0862,2,WCR2019_0223,WCR2019_0087,within-group subordinate,within-group subordinate,352,294,58,44,53,338,347,1,99999,6068,7299,5270,0.108386170594569,0,0,NA,NA,none,hothiphop.parents,hot.parents
2019,1,WCR2019_0862,3,WCR2019_0126,WCR2019_0641,within-group subordinate,within-group subordinate,357,238,119,121,77,359,315,1,99999,5306,6166,3958,0.108386170594569,0,0,NA,NA,none,hothiphop.parents,hot.parents
2019,1,WCR2019_0863,1,WCR2019_0532,WCR2019_0122,within-group subordinate,within-group subordinate,278,239,39,6,36,245,275,1,99999,8289,8288,8225,0.0966119956901712,0,0,NA,NA,none,hothiphop.parents,hot.parents
2019,1,WCR2019_0863,2,WCR2019_0532,WCR2019_0327,within-group subordinate,within-group subordinate,281,248,33,6,32,254,280,1,99999,8289,8203,8142,0.0966119956901712,0,0,NA,NA,none,hothiphop.parents,hot.parents
2019,1,WCR2019_0863,3,WCR2019_0532,WCR2019_0641,within-group subordinate,within-group subordinate,286,194,92,6,92,200,286,1,99999,8289,6160,6109,0.0966119956901712,0,0,NA,NA,none,hothiphop.parents,hot.parents
2019,1,WCR2019_0864,1,WCR2019_0208,WCR2019_0327,within-group subordinate,within-group subordinate,315,262,53,34,24,296,286,1,99999,8261,8200,8114,0.118309184528799,0,0,NA,NA,none,hothiphop.parents,hot.parents
2019,1,WCR2019_0864,2,WCR2019_0208,WCR2019_0641,within-group subordinate,within-group subordinate,320,248,72,34,63,282,311,1,99999,8261,6162,6101,0.118309184528799,0,0,NA,NA,none,hothiphop.parents,hot.parents
2019,1,WCR2019_0864,3,WCR2019_0223,WCR2019_0641,within-group subordinate,within-group subordinate,340,283,57,42,63,325,346,1,99999,6062,6162,4550,0.118309184528799,0,0,NA,NA,none,hothiphop.parents,hot.parents
2019,1,WCR2019_0865,1,WCR2019_0223,WCR2019_0641,within-group subordinate,within-group subordinate,316,246,70,49,64,295,310,1,99999,6059,6166,4549,0.119645848289064,0,0,NA,NA,none,hothiphop.parents,hot.parents
2019,1,WCR2019_0865,2,WCR2019_0223,WCR2019_0327,within-group subordinate,within-group subordinate,344,287,57,49,27,336,314,1,99999,6059,8209,5974,0.119645848289064,0,0,NA,NA,none,hothiphop.parents,hot.parents
2019,1,WCR2019_0865,3,WCR2019_0126,WCR2019_0641,within-group subordinate,within-group subordinate,353,232,121,129,64,361,296,1,99999,5306,6166,3959,0.119645848289064,0,0,NA,NA,none,hothiphop.parents,hot.parents
2019,1,WCR2019_0866,1,WCR2019_0223,WCR2019_0359,within-group subordinate,within-group subordinate,198,146,52,53,5,199,151,1,99999,6042,8217,5968,0.116510679145668,0,0,NA,NA,none,hothiphop.parents,hot.parents
2019,1,WCR2019_0866,2,WCR2019_0008,WCR2019_0359,within-group subordinate,within-group subordinate,230,200,30,30,5,230,205,1,99999,8200,8217,8087,0.116510679145668,0,0,NA,NA,none,hothiphop.parents,hot.parents
2019,1,WCR2019_0866,3,WCR2019_0223,WCR2019_0641,within-group subordinate,within-group subordinate,231,176,55,53,55,229,231,1,99999,6042,6150,4541,0.116510679145668,0,0,NA,NA,none,hothiphop.parents,hot.parents
2019,1,WCR2019_0868,1,WCR2019_0223,WCR2019_0641,within-group subordinate,within-group subordinate,269,212,57,37,62,249,274,1,99999,6061,6167,4552,0.134122995932041,0,0,NA,NA,none,hothiphop.parents,hot.parents
2019,1,WCR2019_0868,2,WCR2019_0223,WCR2019_0161,within-group subordinate,within-group subordinate,313,272,41,37,21,309,293,1,99999,6061,8225,5967,0.134122995932041,0,0,NA,NA,none,hothiphop.parents,hot.parents
2019,1,WCR2019_0868,3,WCR2019_0223,WCR2019_0122,within-group subordinate,within-group subordinate,314,269,45,37,29,306,298,1,99999,6061,8292,6011,0.134122995932041,0,0,NA,NA,none,hothiphop.parents,hot.parents
2019,1,WCR2019_0869,1,WCR2019_0223,WCR2019_0641,within-group subordinate,within-group subordinate,346,254,92,56,106,310,360,1,99999,6059,6165,4548,0.0905719071548217,0,0,NA,NA,none,hothiphop.parents,hot.parents
2019,1,WCR2019_0869,2,WCR2019_0223,WCR2019_0087,within-group subordinate,within-group subordinate,351,284,67,56,62,340,346,1,99999,6059,7298,5264,0.0905719071548217,0,0,NA,NA,none,hothiphop.parents,hot.parents
2019,1,WCR2019_0869,3,WCR2019_0223,WCR2019_0327,within-group subordinate,within-group subordinate,384,323,61,56,37,379,360,1,99999,6059,8209,5975,0.0905719071548217,0,0,NA,NA,none,hothiphop.parents,hot.parents
2019,1,WCR2019_0870,1,WCR2019_0223,WCR2019_0461,within-group subordinate,within-group subordinate,278,224,54,51,7,275,231,1,99999,6067,8324,6045,0.101386896221903,0,0,NA,NA,none,hothiphop.parents,hot.parents
2019,1,WCR2019_0870,2,WCR2019_0440,WCR2019_0461,within-group subordinate,within-group subordinate,312,246,66,62,7,308,253,1,99999,6951,8324,6923,0.101386896221903,0,0,NA,NA,none,hothiphop.parents,hot.parents
2019,1,WCR2019_0870,3,WCR2019_0191,WCR2019_0461,within-group subordinate,within-group subordinate,318,230,88,83,7,313,237,1,99999,7064,8324,7034,0.101386896221903,0,0,NA,NA,none,hothiphop.parents,hot.parents
2019,1,WCR2019_0871,1,WCR2019_0223,WCR2019_0641,within-group subordinate,within-group subordinate,365,280,85,57,92,337,372,1,99999,6058,6168,4554,0.0937387764874895,0,0,NA,NA,none,hothiphop.parents,hot.parents
2019,1,WCR2019_0871,2,WCR2019_0223,WCR2019_0087,within-group subordinate,within-group subordinate,376,305,71,57,64,362,369,1,99999,6058,7294,5263,0.0937387764874895,0,0,NA,NA,none,hothiphop.parents,hot.parents
2019,1,WCR2019_0871,3,WCR2019_0223,WCR2019_0073,within-group subordinate,within-group subordinate,400,320,80,57,78,377,398,1,99999,6058,7963,5740,0.0937387764874895,0,0,NA,NA,none,hothiphop.parents,hot.parents
2019,1,WCR2019_0872,1,WCR2019_0223,WCR2019_0641,within-group subordinate,within-group subordinate,369,293,76,43,85,336,378,1,99999,6069,6171,4555,0.117351816443595,0,0,NA,NA,none,hothiphop.parents,hot.parents
2019,1,WCR2019_0872,2,WCR2019_0223,WCR2019_0327,within-group subordinate,within-group subordinate,382,338,44,43,25,381,363,1,99999,6069,8218,5984,0.117351816443595,0,0,NA,NA,none,hothiphop.parents,hot.parents
2019,1,WCR2019_0872,3,WCR2019_0126,WCR2019_0641,within-group subordinate,within-group subordinate,396,271,125,129,85,400,356,1,99999,5308,6171,3958,0.117351816443595,0,0,NA,NA,none,hothiphop.parents,hot.parents
2019,1,WCR2019_0873,1,WCR2019_0223,WCR2019_0641,within-group subordinate,within-group subordinate,224,199,25,22,18,221,217,1,99999,6056,6167,4550,0.173033169680278,0,0,NA,NA,none,hothiphop.parents,hot.parents
2019,1,WCR2019_0873,2,WCR2019_0223,WCR2019_0088,within-group subordinate,within-group subordinate,248,233,15,22,3,255,236,1,99999,6056,7385,5341,0.173033169680278,0,0,NA,NA,none,hothiphop.parents,hot.parents
2019,1,WCR2019_0873,3,WCR2019_0558,WCR2019_0641,within-group subordinate,within-group subordinate,253,212,41,41,18,253,230,1,99999,8313,6167,6145,0.173033169680278,0,0,NA,NA,none,hothiphop.parents,hot.parents
2019,1,WCR2019_0874,1,WCR2019_0409,WCR2019_0398,within-group subordinate,within-group subordinate,89,58,31,9,25,67,83,1,99999,8243,8245,8216,0.0255046536927354,0,0,NA,NA,none,hothiphop.parents,hot.parents
2019,1,WCR2019_0874,2,WCR2019_0409,WCR2019_0405,within-group subordinate,within-group subordinate,92,62,30,9,25,71,87,1,99999,8243,8112,8084,0.0255046536927354,0,0,NA,NA,none,hothiphop.parents,hot.parents
2019,1,WCR2019_0874,3,WCR2019_0409,WCR2019_0645,within-group subordinate,within-group subordinate,94,62,32,9,25,71,87,1,99999,8243,8256,8227,0.0255046536927354,0,0,NA,NA,none,hothiphop.parents,hot.parents
2019,1,WCR2019_0876,1,WCR2019_0292,WCR2019_0405,within-group subordinate,within-group subordinate,200,188,12,14,0,202,188,1,99999,8326,8193,8163,0.100346848463103,0,0,NA,NA,none,hothiphop.parents,hot.parents
2019,1,WCR2019_0876,2,WCR2019_0292,WCR2019_0641,within-group subordinate,within-group subordinate,205,160,45,14,41,174,201,1,99999,8326,6168,6143,0.100346848463103,0,0,NA,NA,none,hothiphop.parents,hot.parents
2019,1,WCR2019_0876,3,WCR2019_0292,WCR2019_0122,within-group subordinate,within-group subordinate,207,179,28,14,17,193,196,1,99999,8326,8295,8260,0.100346848463103,0,0,NA,NA,none,hothiphop.parents,hot.parents
2019,1,WCR2019_0878,1,WCR2019_0223,WCR2019_0641,within-group subordinate,within-group subordinate,257,224,33,20,37,244,261,1,99999,6058,6163,4549,0.146414461869987,0,0,NA,NA,none,hothiphop.parents,hot.parents
2019,1,WCR2019_0878,2,WCR2019_0223,WCR2019_0327,within-group subordinate,within-group subordinate,314,293,21,20,12,313,305,1,99999,6058,8202,5972,0.146414461869987,0,0,NA,NA,none,hothiphop.parents,hot.parents
2019,1,WCR2019_0878,3,WCR2019_0440,WCR2019_0641,within-group subordinate,within-group subordinate,314,272,42,27,37,299,309,1,99999,6942,6163,5165,0.146414461869987,0,0,NA,NA,none,hothiphop.parents,hot.parents
2019,1,WCR2019_0880,1,WCR2019_0337,WCR2019_0405,within-group subordinate,within-group subordinate,18,4,14,13,2,17,6,1,99999,8308,8198,8140,0.175830743485537,0,0,NA,NA,none,hothiphop.parents,hot.parents
2019,1,WCR2019_0880,2,WCR2019_0337,WCR2019_0617,within-group subordinate,within-group subordinate,97,62,35,13,23,75,85,1,99999,8308,8340,8282,0.175830743485537,0,0,NA,NA,none,hothiphop.parents,hot.parents
2019,1,WCR2019_0880,3,WCR2019_0337,WCR2019_0088,within-group subordinate,within-group subordinate,98,83,15,13,3,96,86,1,99999,8308,7391,7335,0.175830743485537,0,0,NA,NA,none,hothiphop.parents,hot.parents
2019,1,WCR2019_0881,1,WCR2019_0532,WCR2019_0327,within-group subordinate,within-group subordinate,290,252,38,6,36,258,288,1,99999,8299,8213,8151,0.0973218555714969,0,0,NA,NA,none,hothiphop.parents,hot.parents
2019,1,WCR2019_0881,2,WCR2019_0532,WCR2019_0122,within-group subordinate,within-group subordinate,295,249,46,6,45,255,294,1,99999,8299,8298,8234,0.0973218555714969,0,0,NA,NA,none,hothiphop.parents,hot.parents
2019,1,WCR2019_0881,3,WCR2019_0532,WCR2019_0641,within-group subordinate,within-group subordinate,304,212,92,6,91,218,303,1,99999,8299,6173,6121,0.0973218555714969,0,0,NA,NA,none,hothiphop.parents,hot.parents
2019,1,WCR2019_0882,1,WCR2019_0337,WCR2019_0405,within-group subordinate,within-group subordinate,18,3,15,9,6,12,9,1,99999,8312,8203,8145,0.176821983273596,0,0,NA,NA,none,hothiphop.parents,hot.parents
2019,1,WCR2019_0882,2,WCR2019_0337,WCR2019_0088,within-group subordinate,within-group subordinate,92,79,13,9,6,88,85,1,99999,8312,7399,7343,0.176821983273596,0,0,NA,NA,none,hothiphop.parents,hot.parents
2019,1,WCR2019_0882,3,WCR2019_0337,WCR2019_0122,within-group subordinate,within-group subordinate,94,81,13,9,4,90,85,1,99999,8312,8304,8247,0.176821983273596,0,0,NA,NA,none,hothiphop.parents,hot.parents
2019,1,WCR2019_0883,1,WCR2019_0223,WCR2019_0641,within-group subordinate,within-group subordinate,272,215,57,32,74,247,289,1,99999,6064,6166,4551,0.12336963025009,0,0,NA,NA,none,hothiphop.parents,hot.parents
2019,1,WCR2019_0883,2,WCR2019_0223,WCR2019_0327,within-group subordinate,within-group subordinate,305,268,37,32,28,300,296,1,99999,6064,8206,5978,0.12336963025009,0,0,NA,NA,none,hothiphop.parents,hot.parents
2019,1,WCR2019_0883,3,WCR2019_0223,WCR2019_0161,within-group subordinate,within-group subordinate,314,271,43,32,47,303,318,1,99999,6064,8223,5969,0.12336963025009,0,0,NA,NA,none,hothiphop.parents,hot.parents
2019,1,WCR2019_0885,1,WCR2019_0223,WCR2019_0641,within-group subordinate,within-group subordinate,310,237,73,67,66,304,303,1,99999,6044,6157,4545,0.125449748141041,0,0,NA,NA,none,hothiphop.parents,hot.parents
2019,1,WCR2019_0885,2,WCR2019_0440,WCR2019_0641,within-group subordinate,within-group subordinate,338,269,69,59,66,328,335,1,99999,6933,6157,5161,0.125449748141041,0,0,NA,NA,none,hothiphop.parents,hot.parents
2019,1,WCR2019_0885,3,WCR2019_0223,WCR2019_0327,within-group subordinate,within-group subordinate,358,288,70,67,51,355,339,1,99999,6044,8191,5962,0.125449748141041,0,0,NA,NA,none,hothiphop.parents,hot.parents
2019,1,WCR2019_0931,1,WCR2019_0532,WCR2019_0327,within-group subordinate,within-group subordinate,258,226,32,5,33,231,259,1,99999,8288,8202,8140,0.0891895127499102,0,0,NA,NA,none,hothiphop.parents,hot.parents
2019,1,WCR2019_0931,2,WCR2019_0532,WCR2019_0087,within-group subordinate,within-group subordinate,280,222,58,5,59,227,281,1,99999,8288,7298,7239,0.0891895127499102,0,0,NA,NA,none,hothiphop.parents,hot.parents
2019,1,WCR2019_0931,3,WCR2019_0532,WCR2019_0641,within-group subordinate,within-group subordinate,285,190,95,5,93,195,283,1,99999,8288,6165,6113,0.0891895127499102,0,0,NA,NA,none,hothiphop.parents,hot.parents
2019,1,WCR2019_0932,1,WCR2019_0482,WCR2019_0475,within-group subordinate,within-group subordinate,163,127,36,28,8,155,135,1,99999,8255,8333,8229,0.139610001196315,0,0,NA,NA,none,hothiphop.parents,hot.parents
2019,1,WCR2019_0932,2,WCR2019_0223,WCR2019_0475,within-group subordinate,within-group subordinate,252,202,50,43,8,245,210,1,99999,6062,8333,6051,0.139610001196315,0,0,NA,NA,none,hothiphop.parents,hot.parents
2019,1,WCR2019_0932,3,WCR2019_0290,WCR2019_0475,within-group subordinate,within-group subordinate,283,211,72,65,8,276,219,1,99999,8310,8333,8286,0.139610001196315,0,0,NA,NA,none,hothiphop.parents,hot.parents
2019,1,WCR2019_0933,1,WCR2019_0223,WCR2019_0641,within-group subordinate,within-group subordinate,280,225,55,40,59,265,284,1,99999,6044,6155,4540,0.131806188534421,0,0,NA,NA,none,hothiphop.parents,hot.parents
2019,1,WCR2019_0933,2,WCR2019_0482,WCR2019_0641,within-group subordinate,within-group subordinate,288,217,71,32,59,249,276,1,99999,8233,6155,6084,0.131806188534421,0,0,NA,NA,none,hothiphop.parents,hot.parents
2019,1,WCR2019_0933,3,WCR2019_0482,WCR2019_0327,within-group subordinate,within-group subordinate,298,247,51,32,32,279,279,1,99999,8233,8190,8086,0.131806188534421,0,0,NA,NA,none,hothiphop.parents,hot.parents
2019,1,WCR2019_0934,1,WCR2019_0223,WCR2019_0641,within-group subordinate,within-group subordinate,377,312,65,43,72,355,384,1,99999,5998,6089,4493,0.127963231736817,0,0,NA,NA,none,hothiphop.parents,hot.parents
2019,1,WCR2019_0934,2,WCR2019_0223,WCR2019_0327,within-group subordinate,within-group subordinate,425,380,45,43,19,423,399,1,99999,5998,8118,5913,0.127963231736817,0,0,NA,NA,none,hothiphop.parents,hot.parents
2019,1,WCR2019_0934,3,WCR2019_0126,WCR2019_0641,within-group subordinate,within-group subordinate,433,318,115,115,72,433,390,1,99999,5248,6089,3908,0.127963231736817,0,0,NA,NA,none,hothiphop.parents,hot.parents
2019,1,WCR2019_0935,1,WCR2019_0223,WCR2019_0641,within-group subordinate,within-group subordinate,373,302,71,45,72,347,374,1,99999,6056,6161,4548,0.0962758951023829,0,0,NA,NA,none,hothiphop.parents,hot.parents
2019,1,WCR2019_0935,2,WCR2019_0223,WCR2019_0087,within-group subordinate,within-group subordinate,392,332,60,45,54,377,386,1,99999,6056,7290,5261,0.0962758951023829,0,0,NA,NA,none,hothiphop.parents,hot.parents
2019,1,WCR2019_0935,3,WCR2019_0126,WCR2019_0641,within-group subordinate,within-group subordinate,398,277,121,126,72,403,349,1,99999,5290,6161,3946,0.0962758951023829,0,0,NA,NA,none,hothiphop.parents,hot.parents
2019,1,WCR2019_0936,1,WCR2019_0420,WCR2019_0405,within-group subordinate,within-group subordinate,6,4,2,1,1,5,5,1,99999,8316,8166,8150,0.0231609264370575,0,0,NA,NA,none,hothiphop.parents,hot.parents
2019,1,WCR2019_0936,2,WCR2019_0474,WCR2019_0405,within-group subordinate,within-group subordinate,48,37,11,11,1,48,38,1,99999,7995,8166,7846,0.0231609264370575,0,0,NA,NA,none,hothiphop.parents,hot.parents
2019,1,WCR2019_0936,3,WCR2019_0064,WCR2019_0405,within-group subordinate,within-group subordinate,50,35,15,15,1,50,36,1,99999,7283,8166,7159,0.0231609264370575,0,0,NA,NA,none,hothiphop.parents,hot.parents
2019,1,WCR2019_0937,1,WCR2019_0409,WCR2019_0398,within-group subordinate,within-group subordinate,82,51,31,14,25,65,76,1,99999,8285,8288,8257,0.0251292533365396,0,0,NA,NA,none,hothiphop.parents,hot.parents
2019,1,WCR2019_0937,2,WCR2019_0409,WCR2019_0068,within-group subordinate,within-group subordinate,94,62,32,14,24,76,86,1,99999,8285,8296,8264,0.0251292533365396,0,0,NA,NA,none,hothiphop.parents,hot.parents
2019,1,WCR2019_0937,3,WCR2019_0409,WCR2019_0645,within-group subordinate,within-group subordinate,95,57,38,14,27,71,84,1,99999,8285,8300,8269,0.0251292533365396,0,0,NA,NA,none,hothiphop.parents,hot.parents
2019,1,WCR2019_0938,1,WCR2019_0310,WCR2019_0088,within-group subordinate,within-group subordinate,132,106,26,19,19,125,125,1,99999,8236,7329,7292,0.0686238975474206,0,0,NA,NA,none,hothiphop.parents,hot.parents
2019,1,WCR2019_0938,2,WCR2019_0319,WCR2019_0088,within-group subordinate,within-group subordinate,133,104,29,18,19,122,123,1,99999,8232,7329,7287,0.0686238975474206,0,0,NA,NA,none,hothiphop.parents,hot.parents
2019,1,WCR2019_0938,3,WCR2019_0479,WCR2019_0088,within-group subordinate,within-group subordinate,136,107,29,23,19,130,126,1,99999,8241,7329,7296,0.0686238975474206,0,0,NA,NA,none,hothiphop.parents,hot.parents
2019,1,WCR2019_0939,1,WCR2019_0223,WCR2019_0641,within-group subordinate,within-group subordinate,352,255,97,56,108,311,363,1,99999,6071,6172,4558,0.0872579488405451,0,0,NA,NA,none,hothiphop.parents,hot.parents
2019,1,WCR2019_0939,2,WCR2019_0223,WCR2019_0087,within-group subordinate,within-group subordinate,362,292,70,56,61,348,353,1,99999,6071,7305,5274,0.0872579488405451,0,0,NA,NA,none,hothiphop.parents,hot.parents
2019,1,WCR2019_0939,3,WCR2019_0126,WCR2019_0641,within-group subordinate,within-group subordinate,365,219,146,140,108,359,327,1,99999,5307,6172,3959,0.0872579488405451,0,0,NA,NA,none,hothiphop.parents,hot.parents
2019,1,WCR2019_0940,1,WCR2019_0223,WCR2019_0641,within-group subordinate,within-group subordinate,272,228,44,27,56,255,284,1,99999,6052,6153,4543,0.133141417776178,0,0,NA,NA,none,hothiphop.parents,hot.parents
2019,1,WCR2019_0940,2,WCR2019_0482,WCR2019_0641,within-group subordinate,within-group subordinate,307,218,89,57,56,275,274,1,99999,8233,6153,6083,0.133141417776178,0,0,NA,NA,none,hothiphop.parents,hot.parents
2019,1,WCR2019_0940,3,WCR2019_0482,WCR2019_0327,within-group subordinate,within-group subordinate,320,253,67,57,14,310,267,1,99999,8233,8186,8083,0.133141417776178,0,0,NA,NA,none,hothiphop.parents,hot.parents
2019,1,WCR2019_0941,1,WCR2019_0223,WCR2019_0047,within-group subordinate,within-group subordinate,230,192,38,32,12,224,204,1,99999,6067,8353,6059,0.135836422336482,0,0,NA,NA,none,hothiphop.parents,hot.parents
2019,1,WCR2019_0941,2,WCR2019_0223,WCR2019_0641,within-group subordinate,within-group subordinate,253,214,39,32,50,246,264,1,99999,6067,6173,4558,0.135836422336482,0,0,NA,NA,none,hothiphop.parents,hot.parents
2019,1,WCR2019_0941,3,WCR2019_0440,WCR2019_0047,within-group subordinate,within-group subordinate,275,228,47,41,12,269,240,1,99999,6955,8353,6946,0.135836422336482,0,0,NA,NA,none,hothiphop.parents,hot.parents
2019,1,WCR2019_0942,1,WCR2019_0208,WCR2019_0327,within-group subordinate,within-group subordinate,334,280,54,33,32,313,312,1,99999,8273,8214,8126,0.114285714285714,0,0,NA,NA,none,hothiphop.parents,hot.parents
2019,1,WCR2019_0942,2,WCR2019_0208,WCR2019_0641,within-group subordinate,within-group subordinate,350,262,88,33,80,295,342,1,99999,8273,6171,6109,0.114285714285714,0,0,NA,NA,none,hothiphop.parents,hot.parents
2019,1,WCR2019_0942,3,WCR2019_0223,WCR2019_0641,within-group subordinate,within-group subordinate,360,287,73,50,80,337,367,1,99999,6071,6171,4559,0.114285714285714,0,0,NA,NA,none,hothiphop.parents,hot.parents
2019,1,WCR2019_0944,1,WCR2019_0256,WCR2019_0461,within-group subordinate,within-group subordinate,128,102,26,21,10,123,112,1,99999,8307,8331,8272,0.15255047186716,0,0,NA,NA,none,hothiphop.parents,hot.parents
2019,1,WCR2019_0944,2,WCR2019_0522,WCR2019_0461,within-group subordinate,within-group subordinate,131,102,29,21,10,123,112,1,99999,8347,8331,8307,0.15255047186716,0,0,NA,NA,none,hothiphop.parents,hot.parents
2019,1,WCR2019_0944,3,WCR2019_0263,WCR2019_0461,within-group subordinate,within-group subordinate,135,110,25,18,10,128,120,1,99999,8318,8331,8279,0.15255047186716,0,0,NA,NA,none,hothiphop.parents,hot.parents
2019,1,WCR2019_0945,1,WCR2019_0008,WCR2019_0445,within-group subordinate,within-group subordinate,259,213,46,43,6,256,219,1,99999,8189,8285,8149,0.103183183183183,0,0,NA,NA,none,hothiphop.parents,hot.parents
2019,1,WCR2019_0945,2,WCR2019_0223,WCR2019_0445,within-group subordinate,within-group subordinate,259,194,65,64,6,258,200,1,99999,6039,8285,6017,0.103183183183183,0,0,NA,NA,none,hothiphop.parents,hot.parents
2019,1,WCR2019_0945,3,WCR2019_0267,WCR2019_0445,within-group subordinate,within-group subordinate,268,199,69,68,6,267,205,1,99999,8265,8285,8227,0.103183183183183,0,0,NA,NA,none,hothiphop.parents,hot.parents
2019,1,WCR2019_0946,1,WCR2019_0223,WCR2019_0257,within-group subordinate,within-group subordinate,277,212,65,63,6,275,218,1,99999,6060,8316,6038,0.135982762748384,0,0,NA,NA,none,hothiphop.parents,hot.parents
2019,1,WCR2019_0946,2,WCR2019_0440,WCR2019_0257,within-group subordinate,within-group subordinate,313,255,58,55,6,310,261,1,99999,6946,8316,6921,0.135982762748384,0,0,NA,NA,none,hothiphop.parents,hot.parents
2019,1,WCR2019_0946,3,WCR2019_0223,WCR2019_0641,within-group subordinate,within-group subordinate,318,257,61,63,56,320,313,1,99999,6060,6165,4550,0.135982762748384,0,0,NA,NA,none,hothiphop.parents,hot.parents
2019,1,WCR2019_0947,1,WCR2019_0223,WCR2019_0641,within-group subordinate,within-group subordinate,254,214,40,32,42,246,256,1,99999,6070,6173,4557,0.145930441018286,0,0,NA,NA,none,hothiphop.parents,hot.parents
2019,1,WCR2019_0947,2,WCR2019_0482,WCR2019_0641,within-group subordinate,within-group subordinate,283,225,58,30,42,255,267,1,99999,8262,6173,6102,0.145930441018286,0,0,NA,NA,none,hothiphop.parents,hot.parents
2019,1,WCR2019_0947,3,WCR2019_0223,WCR2019_0075,within-group subordinate,within-group subordinate,302,262,40,32,31,294,293,1,99999,6070,7821,5638,0.145930441018286,0,0,NA,NA,none,hothiphop.parents,hot.parents
2019,1,WCR2019_0948,1,WCR2019_0482,WCR2019_0475,within-group subordinate,within-group subordinate,213,144,69,62,9,206,153,1,99999,8237,8315,8211,0.12780242177197,0,0,NA,NA,none,hothiphop.parents,hot.parents
2019,1,WCR2019_0948,2,WCR2019_0223,WCR2019_0475,within-group subordinate,within-group subordinate,259,214,45,40,9,254,223,1,99999,6051,8315,6040,0.12780242177197,0,0,NA,NA,none,hothiphop.parents,hot.parents
2019,1,WCR2019_0948,3,WCR2019_0440,WCR2019_0475,within-group subordinate,within-group subordinate,303,240,63,59,9,299,249,1,99999,6930,8315,6910,0.12780242177197,0,0,NA,NA,none,hothiphop.parents,hot.parents
2019,1,WCR2019_0949,1,WCR2019_0223,WCR2019_0087,within-group subordinate,within-group subordinate,369,305,64,52,57,357,362,1,99999,6051,7288,5259,0.0958657878969443,0,0,NA,NA,none,hothiphop.parents,hot.parents
2019,1,WCR2019_0949,2,WCR2019_0223,WCR2019_0641,within-group subordinate,within-group subordinate,383,296,87,52,97,348,393,1,99999,6051,6159,4547,0.0958657878969443,0,0,NA,NA,none,hothiphop.parents,hot.parents
2019,1,WCR2019_0949,3,WCR2019_0223,WCR2019_0073,within-group subordinate,within-group subordinate,395,326,69,52,63,378,389,1,99999,6051,7958,5735,0.0958657878969443,0,0,NA,NA,none,hothiphop.parents,hot.parents
2019,1,WCR2019_0950,1,WCR2019_0441,WCR2019_0088,within-group subordinate,within-group subordinate,228,198,30,22,23,220,221,1,99999,8323,7383,7363,0.0934579439252336,0,0,NA,NA,none,hothiphop.parents,hot.parents
2019,1,WCR2019_0950,2,WCR2019_0499,WCR2019_0088,within-group subordinate,within-group subordinate,228,197,31,17,23,214,220,1,99999,8305,7383,7346,0.0934579439252336,0,0,NA,NA,none,hothiphop.parents,hot.parents
2019,1,WCR2019_0950,3,WCR2019_0008,WCR2019_0088,within-group subordinate,within-group subordinate,229,196,33,21,23,217,219,1,99999,8213,7383,7272,0.0934579439252336,0,0,NA,NA,none,hothiphop.parents,hot.parents
2019,1,WCR2019_0953,1,WCR2019_0223,WCR2019_0150,within-group subordinate,within-group subordinate,262,212,50,48,4,260,216,1,99999,6051,8321,6033,0.10918024928092,0,0,NA,NA,none,hothiphop.parents,hot.parents
2019,1,WCR2019_0953,2,WCR2019_0440,WCR2019_0150,within-group subordinate,within-group subordinate,286,237,49,46,4,283,241,1,99999,6936,8321,6914,0.10918024928092,0,0,NA,NA,none,hothiphop.parents,hot.parents
2019,1,WCR2019_0953,3,WCR2019_0008,WCR2019_0150,within-group subordinate,within-group subordinate,303,263,40,37,4,300,267,1,99999,8207,8321,8185,0.10918024928092,0,0,NA,NA,none,hothiphop.parents,hot.parents
2019,1,WCR2019_0954,1,WCR2019_0008,WCR2019_0641,within-group subordinate,within-group subordinate,230,205,25,10,22,215,227,1,99999,8203,6152,6066,0.144741575728505,0,0,NA,NA,none,hothiphop.parents,hot.parents
2019,1,WCR2019_0954,2,WCR2019_0403,WCR2019_0641,within-group subordinate,within-group subordinate,235,207,28,12,22,219,229,1,99999,8222,6152,6073,0.144741575728505,0,0,NA,NA,none,hothiphop.parents,hot.parents
2019,1,WCR2019_0954,3,WCR2019_0488,WCR2019_0641,within-group subordinate,within-group subordinate,236,204,32,16,22,220,226,1,99999,8302,6152,6127,0.144741575728505,0,0,NA,NA,none,hothiphop.parents,hot.parents
2019,1,WCR2019_0955,1,WCR2019_0223,WCR2019_0641,within-group subordinate,within-group subordinate,310,244,66,46,64,290,308,1,99999,6074,6172,4561,0.126927214055217,0,0,NA,NA,none,hothiphop.parents,hot.parents
2019,1,WCR2019_0955,2,WCR2019_0223,WCR2019_0161,within-group subordinate,within-group subordinate,327,273,54,46,31,319,304,1,99999,6074,8233,5979,0.126927214055217,0,0,NA,NA,none,hothiphop.parents,hot.parents
2019,1,WCR2019_0955,3,WCR2019_0223,WCR2019_0327,within-group subordinate,within-group subordinate,333,281,52,46,22,327,303,1,99999,6074,8216,5988,0.126927214055217,0,0,NA,NA,none,hothiphop.parents,hot.parents
2019,1,WCR2019_0956,1,WCR2019_0223,WCR2019_0475,within-group subordinate,within-group subordinate,219,169,50,46,6,215,175,1,99999,5931,8143,5920,0.126820908311911,0,0,NA,NA,none,hothiphop.parents,hot.parents
2019,1,WCR2019_0956,2,WCR2019_0008,WCR2019_0475,within-group subordinate,within-group subordinate,227,196,31,29,6,225,202,1,99999,8041,8143,8015,0.126820908311911,0,0,NA,NA,none,hothiphop.parents,hot.parents
2019,1,WCR2019_0956,3,WCR2019_0440,WCR2019_0475,within-group subordinate,within-group subordinate,243,178,65,63,6,241,184,1,99999,6779,8143,6759,0.126820908311911,0,0,NA,NA,none,hothiphop.parents,hot.parents
2019,1,WCR2019_0957,1,WCR2019_0008,WCR2019_0047,within-group subordinate,within-group subordinate,219,191,28,24,6,215,197,1,99999,8219,8347,8210,0.1249401627573,0,0,NA,NA,none,hothiphop.parents,hot.parents
2019,1,WCR2019_0957,2,WCR2019_0223,WCR2019_0047,within-group subordinate,within-group subordinate,224,145,79,74,6,219,151,1,99999,6062,8347,6055,0.1249401627573,0,0,NA,NA,none,hothiphop.parents,hot.parents
2019,1,WCR2019_0957,3,WCR2019_0256,WCR2019_0047,within-group subordinate,within-group subordinate,233,207,26,20,6,227,213,1,99999,8292,8347,8283,0.1249401627573,0,0,NA,NA,none,hothiphop.parents,hot.parents
2019,1,WCR2019_0959,1,WCR2019_0223,WCR2019_0257,within-group subordinate,within-group subordinate,255,200,55,53,2,253,202,1,99999,6063,8320,6041,0.132806891600861,0,0,NA,NA,none,hothiphop.parents,hot.parents
2019,1,WCR2019_0959,2,WCR2019_0223,WCR2019_0641,within-group subordinate,within-group subordinate,272,224,48,53,45,277,269,1,99999,6063,6173,4557,0.132806891600861,0,0,NA,NA,none,hothiphop.parents,hot.parents
2019,1,WCR2019_0959,3,WCR2019_0008,WCR2019_0257,within-group subordinate,within-group subordinate,281,257,24,23,2,280,259,1,99999,8221,8320,8183,0.132806891600861,0,0,NA,NA,none,hothiphop.parents,hot.parents
2019,1,WCR2019_0961,1,WCR2019_0585,WCR2019_0087,within-group subordinate,within-group subordinate,281,222,59,3,57,225,279,1,99999,8327,7295,7272,0.0899185823754789,0,0,NA,NA,none,hothiphop.parents,hot.parents
2019,1,WCR2019_0961,2,WCR2019_0585,WCR2019_0327,within-group subordinate,within-group subordinate,283,246,37,3,35,249,281,1,99999,8327,8201,8177,0.0899185823754789,0,0,NA,NA,none,hothiphop.parents,hot.parents
2019,1,WCR2019_0961,3,WCR2019_0585,WCR2019_0161,within-group subordinate,within-group subordinate,286,229,57,3,55,232,284,1,99999,8327,8218,8193,0.0899185823754789,0,0,NA,NA,none,hothiphop.parents,hot.parents
2019,1,WCR2019_0963,1,WCR2019_0585,WCR2019_0327,within-group subordinate,within-group subordinate,287,253,34,5,31,258,284,1,99999,8333,8207,8183,0.0944005743000718,0,0,NA,NA,none,hothiphop.parents,hot.parents
2019,1,WCR2019_0963,2,WCR2019_0585,WCR2019_0087,within-group subordinate,within-group subordinate,295,239,56,5,52,244,291,1,99999,8333,7297,7274,0.0944005743000718,0,0,NA,NA,none,hothiphop.parents,hot.parents
2019,1,WCR2019_0963,3,WCR2019_0585,WCR2019_0161,within-group subordinate,within-group subordinate,311,261,50,5,47,266,308,1,99999,8333,8224,8199,0.0944005743000718,0,0,NA,NA,none,hothiphop.parents,hot.parents
2019,1,WCR2019_0964,1,WCR2019_0223,WCR2019_0258,within-group subordinate,within-group subordinate,223,181,42,37,10,218,191,1,99999,6072,8289,6029,0.144939658262636,0,0,NA,NA,none,hothiphop.parents,hot.parents
2019,1,WCR2019_0964,2,WCR2019_0440,WCR2019_0258,within-group subordinate,within-group subordinate,274,233,41,36,10,269,243,1,99999,6957,8289,6907,0.144939658262636,0,0,NA,NA,none,hothiphop.parents,hot.parents
2019,1,WCR2019_0964,3,WCR2019_0223,WCR2019_0641,within-group subordinate,within-group subordinate,286,229,57,37,57,266,286,1,99999,6072,6175,4560,0.144939658262636,0,0,NA,NA,none,hothiphop.parents,hot.parents
2019,1,WCR2019_0965,1,WCR2019_0223,WCR2019_0641,within-group subordinate,within-group subordinate,340,257,83,54,90,311,347,1,99999,6064,6165,4552,0.0917464114832536,0,0,NA,NA,none,hothiphop.parents,hot.parents
2019,1,WCR2019_0965,2,WCR2019_0223,WCR2019_0087,within-group subordinate,within-group subordinate,345,277,68,54,66,331,343,1,99999,6064,7296,5266,0.0917464114832536,0,0,NA,NA,none,hothiphop.parents,hot.parents
2019,1,WCR2019_0965,3,WCR2019_0223,WCR2019_0073,within-group subordinate,within-group subordinate,365,291,74,54,60,345,351,1,99999,6064,7968,5744,0.0917464114832536,0,0,NA,NA,none,hothiphop.parents,hot.parents
2019,1,WCR2019_0966,1,WCR2019_0223,WCR2019_0641,within-group subordinate,within-group subordinate,375,279,96,74,97,353,376,1,99999,6068,6171,4555,0.109636537541846,0,0,NA,NA,none,hothiphop.parents,hot.parents
2019,1,WCR2019_0966,2,WCR2019_0223,WCR2019_0087,within-group subordinate,within-group subordinate,394,309,85,74,79,383,388,1,99999,6068,7304,5274,0.109636537541846,0,0,NA,NA,none,hothiphop.parents,hot.parents
2019,1,WCR2019_0966,3,WCR2019_0126,WCR2019_0641,within-group subordinate,within-group subordinate,412,269,143,157,97,426,366,1,99999,5305,6171,3956,0.109636537541846,0,0,NA,NA,none,hothiphop.parents,hot.parents
2019,1,WCR2019_0967,1,WCR2019_0223,WCR2019_0641,within-group subordinate,within-group subordinate,235,194,41,51,24,245,218,1,99999,6068,6167,4555,0.158373205741627,0,0,NA,NA,none,hothiphop.parents,hot.parents
2019,1,WCR2019_0967,2,WCR2019_0165,WCR2019_0641,within-group subordinate,within-group subordinate,268,243,25,11,24,254,267,1,99999,8337,6167,6148,0.158373205741627,0,0,NA,NA,none,hothiphop.parents,hot.parents
2019,1,WCR2019_0967,3,WCR2019_0267,WCR2019_0641,within-group subordinate,within-group subordinate,269,244,25,11,24,255,268,1,99999,8299,6167,6128,0.158373205741627,0,0,NA,NA,none,hothiphop.parents,hot.parents
2019,1,WCR2019_0969,1,WCR2019_0141,WCR2019_0088,within-group subordinate,within-group subordinate,175,152,23,16,14,168,166,1,99999,8246,7340,7331,0.0864197530864197,0,0,NA,NA,none,hothiphop.parents,hot.parents
2019,1,WCR2019_0969,2,WCR2019_0409,WCR2019_0088,within-group subordinate,within-group subordinate,178,161,17,9,14,170,175,1,99999,8230,7340,7311,0.0864197530864197,0,0,NA,NA,none,hothiphop.parents,hot.parents
2019,1,WCR2019_0969,3,WCR2019_0409,WCR2019_0075,within-group subordinate,within-group subordinate,180,167,13,9,9,176,176,1,99999,8230,7747,7718,0.0864197530864197,0,0,NA,NA,none,hothiphop.parents,hot.parents
2019,1,WCR2019_0970,1,WCR2019_0223,WCR2019_0641,within-group subordinate,within-group subordinate,284,235,49,30,52,265,287,1,99999,6060,6163,4552,0.144875478927203,0,0,NA,NA,none,hothiphop.parents,hot.parents
2019,1,WCR2019_0970,2,WCR2019_0208,WCR2019_0327,within-group subordinate,within-group subordinate,295,236,59,45,20,281,256,1,99999,8261,8202,8115,0.144875478927203,0,0,NA,NA,none,hothiphop.parents,hot.parents
2019,1,WCR2019_0970,3,WCR2019_0208,WCR2019_0641,within-group subordinate,within-group subordinate,296,219,77,45,52,264,271,1,99999,8261,6163,6102,0.144875478927203,0,0,NA,NA,none,hothiphop.parents,hot.parents
2019,1,WCR2019_0972,1,WCR2019_0223,WCR2019_0641,within-group subordinate,within-group subordinate,331,245,86,52,99,297,344,1,99999,6050,6152,4545,0.104089219330855,0,0,NA,NA,none,hothiphop.parents,hot.parents
2019,1,WCR2019_0972,2,WCR2019_0223,WCR2019_0087,within-group subordinate,within-group subordinate,364,297,67,52,65,349,362,1,99999,6050,7289,5262,0.104089219330855,0,0,NA,NA,none,hothiphop.parents,hot.parents
2019,1,WCR2019_0972,3,WCR2019_0223,WCR2019_0327,within-group subordinate,within-group subordinate,375,313,62,52,45,365,358,1,99999,6050,8189,5965,0.104089219330855,0,0,NA,NA,none,hothiphop.parents,hot.parents
2019,1,WCR2019_0973,1,WCR2019_0390,WCR2019_0213,within-group subordinate,within-group subordinate,17,4,13,6,7,10,11,1,99999,8345,8313,8299,0.123938270128006,0,0,NA,NA,none,hothiphop.parents,hot.parents
2019,1,WCR2019_0973,2,WCR2019_0390,WCR2019_0327,within-group subordinate,within-group subordinate,232,201,31,6,26,207,227,1,99999,8345,8208,8195,0.123938270128006,0,0,NA,NA,none,hothiphop.parents,hot.parents
2019,1,WCR2019_0973,3,WCR2019_0390,WCR2019_0122,within-group subordinate,within-group subordinate,233,198,35,6,29,204,227,1,99999,8345,8293,8280,0.123938270128006,0,0,NA,NA,none,hothiphop.parents,hot.parents
2019,1,WCR2019_0974,1,WCR2019_0223,WCR2019_0279,within-group subordinate,within-group subordinate,243,179,64,58,9,237,188,1,99999,6044,8243,5989,0.0967703205666947,0,0,NA,NA,none,hothiphop.parents,hot.parents
2019,1,WCR2019_0974,2,WCR2019_0440,WCR2019_0279,within-group subordinate,within-group subordinate,277,213,64,60,9,273,222,1,99999,6924,8243,6860,0.0967703205666947,0,0,NA,NA,none,hothiphop.parents,hot.parents
2019,1,WCR2019_0974,3,WCR2019_0008,WCR2019_0279,within-group subordinate,within-group subordinate,302,247,55,50,9,297,256,1,99999,8193,8243,8107,0.0967703205666947,0,0,NA,NA,none,hothiphop.parents,hot.parents
2019,1,WCR2019_0975,1,WCR2019_0223,WCR2019_0641,within-group subordinate,within-group subordinate,369,285,84,53,91,338,376,1,99999,6064,6160,4553,0.101652298850575,0,0,NA,NA,none,hothiphop.parents,hot.parents
2019,1,WCR2019_0975,2,WCR2019_0126,WCR2019_0641,within-group subordinate,within-group subordinate,411,279,132,137,91,416,370,1,99999,5296,6160,3948,0.101652298850575,0,0,NA,NA,none,hothiphop.parents,hot.parents
2019,1,WCR2019_0975,3,WCR2019_0223,WCR2019_0075,within-group subordinate,within-group subordinate,414,340,74,53,74,393,414,1,99999,6064,7804,5630,0.101652298850575,0,0,NA,NA,none,hothiphop.parents,hot.parents
2019,1,WCR2019_0977,1,WCR2019_0064,WCR2019_0258,within-group subordinate,within-group subordinate,65,45,20,18,2,63,47,1,99999,7275,8240,7202,0.0639499939896622,0,0,NA,NA,none,hothiphop.parents,hot.parents
2019,1,WCR2019_0977,2,WCR2019_0474,WCR2019_0258,within-group subordinate,within-group subordinate,67,49,18,16,2,65,51,1,99999,7983,8240,7908,0.0639499939896622,0,0,NA,NA,none,hothiphop.parents,hot.parents
2019,1,WCR2019_0977,3,WCR2019_0324,WCR2019_0258,within-group subordinate,within-group subordinate,73,56,17,16,2,72,58,1,99999,8306,8240,8227,0.0639499939896622,0,0,NA,NA,none,hothiphop.parents,hot.parents
2019,1,WCR2019_0978,1,WCR2019_0223,WCR2019_0539,within-group subordinate,within-group subordinate,228,162,66,62,12,224,174,1,99999,6055,8306,6031,0.129241098189666,0,0,NA,NA,none,hothiphop.parents,hot.parents
2019,1,WCR2019_0978,2,WCR2019_0440,WCR2019_0539,within-group subordinate,within-group subordinate,268,213,55,52,12,265,225,1,99999,6934,8306,6903,0.129241098189666,0,0,NA,NA,none,hothiphop.parents,hot.parents
2019,1,WCR2019_0978,3,WCR2019_0008,WCR2019_0539,within-group subordinate,within-group subordinate,277,231,46,41,12,272,243,1,99999,8206,8306,8173,0.129241098189666,0,0,NA,NA,none,hothiphop.parents,hot.parents
2019,1,WCR2019_0980,1,WCR2019_0474,WCR2019_0516,within-group subordinate,within-group subordinate,76,59,17,10,8,69,67,1,99999,8016,8305,7967,0.176900059844405,0,0,NA,NA,none,hothiphop.parents,hot.parents
2019,1,WCR2019_0980,2,WCR2019_0579,WCR2019_0516,within-group subordinate,within-group subordinate,83,71,12,5,8,76,79,1,99999,8330,8305,8281,0.176900059844405,0,0,NA,NA,none,hothiphop.parents,hot.parents
2019,1,WCR2019_0980,3,WCR2019_0345,WCR2019_0516,within-group subordinate,within-group subordinate,83,70,13,7,8,77,78,1,99999,8287,8305,8237,0.176900059844405,0,0,NA,NA,none,hothiphop.parents,hot.parents
2019,1,WCR2019_0981,1,WCR2019_0223,WCR2019_0641,within-group subordinate,within-group subordinate,390,305,85,44,93,349,398,1,99999,6073,6179,4563,0.101541034523952,0,0,NA,NA,none,hothiphop.parents,hot.parents
2019,1,WCR2019_0981,2,WCR2019_0223,WCR2019_0087,within-group subordinate,within-group subordinate,403,337,66,44,62,381,399,1,99999,6073,7307,5275,0.101541034523952,0,0,NA,NA,none,hothiphop.parents,hot.parents
2019,1,WCR2019_0981,3,WCR2019_0126,WCR2019_0641,within-group subordinate,within-group subordinate,420,286,134,131,93,417,379,1,99999,5309,6179,3963,0.101541034523952,0,0,NA,NA,none,hothiphop.parents,hot.parents
2019,1,WCR2019_0982,1,WCR2019_0421,WCR2019_0388,within-group subordinate,within-group subordinate,15,2,13,7,7,9,9,1,99999,8364,8356,8341,0.121971595655806,0,0,NA,NA,none,hothiphop.parents,hot.parents
2019,1,WCR2019_0982,2,WCR2019_0421,WCR2019_0088,within-group subordinate,within-group subordinate,56,41,15,7,12,48,53,1,99999,8364,7405,7390,0.121971595655806,0,0,NA,NA,none,hothiphop.parents,hot.parents
2019,1,WCR2019_0982,3,WCR2019_0421,WCR2019_0518,within-group subordinate,within-group subordinate,76,57,19,7,14,64,71,1,99999,8364,8348,8334,0.121971595655806,0,0,NA,NA,none,hothiphop.parents,hot.parents
2019,1,WCR2019_0983,1,WCR2019_0223,WCR2019_0641,within-group subordinate,within-group subordinate,278,204,74,53,72,257,276,1,99999,5957,6058,4465,0.114355231143552,0,0,NA,NA,none,hothiphop.parents,hot.parents
2019,1,WCR2019_0983,2,WCR2019_0223,WCR2019_0122,within-group subordinate,within-group subordinate,310,246,64,53,33,299,279,1,99999,5957,8155,5908,0.114355231143552,0,0,NA,NA,none,hothiphop.parents,hot.parents
2019,1,WCR2019_0983,3,WCR2019_0223,WCR2019_0161,within-group subordinate,within-group subordinate,312,254,58,53,21,307,275,1,99999,5957,8086,5862,0.114355231143552,0,0,NA,NA,none,hothiphop.parents,hot.parents
2019,1,WCR2019_0984,1,WCR2019_0280,WCR2019_0537,within-group subordinate,within-group subordinate,21,7,14,5,9,12,16,1,99999,8263,8328,8245,0.125329499161275,0,0,NA,NA,none,hothiphop.parents,hot.parents
2019,1,WCR2019_0984,2,WCR2019_0280,WCR2019_0327,within-group subordinate,within-group subordinate,212,191,21,5,18,196,209,1,99999,8263,8198,8122,0.125329499161275,0,0,NA,NA,none,hothiphop.parents,hot.parents
2019,1,WCR2019_0984,3,WCR2019_0223,WCR2019_0537,within-group subordinate,within-group subordinate,216,139,77,73,9,212,148,1,99999,6058,8328,6047,0.125329499161275,0,0,NA,NA,none,hothiphop.parents,hot.parents
2019,1,WCR2019_0985,1,WCR2019_0421,WCR2019_0258,within-group subordinate,within-group subordinate,18,5,13,5,9,10,14,1,99999,8343,8280,8263,0.110047846889952,0,0,NA,NA,none,hothiphop.parents,hot.parents
2019,1,WCR2019_0985,2,WCR2019_0421,WCR2019_0327,within-group subordinate,within-group subordinate,178,142,36,5,33,147,175,1,99999,8343,8209,8193,0.110047846889952,0,0,NA,NA,none,hothiphop.parents,hot.parents
2019,1,WCR2019_0985,3,WCR2019_0421,WCR2019_0417,within-group subordinate,within-group subordinate,186,142,44,5,42,147,184,1,99999,8343,8339,8322,0.110047846889952,0,0,NA,NA,none,hothiphop.parents,hot.parents
2019,1,WCR2019_0986,1,WCR2019_0223,WCR2019_0641,within-group subordinate,within-group subordinate,333,254,79,49,87,303,341,1,99999,6064,6168,4553,0.0894950945202201,0,0,NA,NA,none,hothiphop.parents,hot.parents
2019,1,WCR2019_0986,2,WCR2019_0223,WCR2019_0087,within-group subordinate,within-group subordinate,352,290,62,49,50,339,340,1,99999,6064,7303,5271,0.0894950945202201,0,0,NA,NA,none,hothiphop.parents,hot.parents
2019,1,WCR2019_0986,3,WCR2019_0126,WCR2019_0641,within-group subordinate,within-group subordinate,356,230,126,131,87,361,317,1,99999,5303,6168,3955,0.0894950945202201,0,0,NA,NA,none,hothiphop.parents,hot.parents
2019,1,WCR2019_0987,1,WCR2019_0223,WCR2019_0641,within-group subordinate,within-group subordinate,275,224,51,36,42,260,266,1,99999,6066,6169,4553,0.143523501973448,0,0,NA,NA,none,hothiphop.parents,hot.parents
2019,1,WCR2019_0987,2,WCR2019_0223,WCR2019_0327,within-group subordinate,within-group subordinate,295,258,37,36,18,294,276,1,99999,6066,8213,5982,0.143523501973448,0,0,NA,NA,none,hothiphop.parents,hot.parents
2019,1,WCR2019_0987,3,WCR2019_0440,WCR2019_0641,within-group subordinate,within-group subordinate,302,256,46,30,42,286,298,1,99999,6950,6169,5171,0.143523501973448,0,0,NA,NA,none,hothiphop.parents,hot.parents
2019,1,WCR2019_0988,1,WCR2019_0223,WCR2019_0641,within-group subordinate,within-group subordinate,275,214,61,42,62,256,276,1,99999,6044,6149,4537,0.130022789972412,0,0,NA,NA,none,hothiphop.parents,hot.parents
2019,1,WCR2019_0988,2,WCR2019_0223,WCR2019_0075,within-group subordinate,within-group subordinate,297,246,51,42,43,288,289,1,99999,6044,7793,5614,0.130022789972412,0,0,NA,NA,none,hothiphop.parents,hot.parents
2019,1,WCR2019_0988,3,WCR2019_0223,WCR2019_0327,within-group subordinate,within-group subordinate,301,255,46,42,30,297,285,1,99999,6044,8187,5959,0.130022789972412,0,0,NA,NA,none,hothiphop.parents,hot.parents
2019,1,WCR2019_0989,1,WCR2019_0223,WCR2019_0641,within-group subordinate,within-group subordinate,318,227,91,63,119,290,346,1,99999,5754,5797,4322,0.0720376734122439,0,0,NA,NA,none,hothiphop.parents,hot.parents
2019,1,WCR2019_0989,2,WCR2019_0223,WCR2019_0087,within-group subordinate,within-group subordinate,340,255,85,63,92,318,347,1,99999,5754,6895,5024,0.0720376734122439,0,0,NA,NA,none,hothiphop.parents,hot.parents
2019,1,WCR2019_0989,3,WCR2019_0223,WCR2019_0322,within-group subordinate,within-group subordinate,340,254,86,63,83,317,337,1,99999,5754,7818,5730,0.0720376734122439,0,0,NA,NA,none,hothiphop.parents,hot.parents
2019,1,WCR2019_0991,1,WCR2019_0223,WCR2019_0641,within-group subordinate,within-group subordinate,249,188,61,68,58,256,246,1,99999,6076,6175,4562,0.12247580356076,0,0,NA,NA,none,hothiphop.parents,hot.parents
2019,1,WCR2019_0991,2,WCR2019_0223,WCR2019_0122,within-group subordinate,within-group subordinate,314,239,75,68,25,307,264,1,99999,6076,8303,6026,0.12247580356076,0,0,NA,NA,none,hothiphop.parents,hot.parents
2019,1,WCR2019_0991,3,WCR2019_0223,WCR2019_0075,within-group subordinate,within-group subordinate,314,237,77,68,42,305,279,1,99999,6076,7822,5642,0.12247580356076,0,0,NA,NA,none,hothiphop.parents,hot.parents
2019,1,WCR2019_0992,1,WCR2019_0223,WCR2019_0641,within-group subordinate,within-group subordinate,333,262,71,47,74,309,336,1,99999,6052,6152,4543,0.0953008870774395,0,0,NA,NA,none,hothiphop.parents,hot.parents
2019,1,WCR2019_0992,2,WCR2019_0223,WCR2019_0087,within-group subordinate,within-group subordinate,369,306,63,47,53,353,359,1,99999,6052,7291,5264,0.0953008870774395,0,0,NA,NA,none,hothiphop.parents,hot.parents
2019,1,WCR2019_0992,3,WCR2019_0126,WCR2019_0641,within-group subordinate,within-group subordinate,374,249,125,133,74,382,323,1,99999,5300,6152,3953,0.0953008870774395,0,0,NA,NA,none,hothiphop.parents,hot.parents
2019,1,WCR2019_0993,1,WCR2019_0585,WCR2019_0087,within-group subordinate,within-group subordinate,291,230,61,6,57,236,287,1,99999,8323,7296,7272,0.0883938196191161,0,0,NA,NA,none,hothiphop.parents,hot.parents
2019,1,WCR2019_0993,2,WCR2019_0585,WCR2019_0327,within-group subordinate,within-group subordinate,293,255,38,6,35,261,290,1,99999,8323,8198,8173,0.0883938196191161,0,0,NA,NA,none,hothiphop.parents,hot.parents
2019,1,WCR2019_0993,3,WCR2019_0585,WCR2019_0641,within-group subordinate,within-group subordinate,304,205,99,6,97,211,302,1,99999,8323,6159,6137,0.0883938196191161,0,0,NA,NA,none,hothiphop.parents,hot.parents
2019,1,WCR2019_0996,1,WCR2019_0223,WCR2019_0641,within-group subordinate,within-group subordinate,365,282,83,45,95,327,377,1,99999,6059,6157,4546,0.104241552839684,0,0,NA,NA,none,hothiphop.parents,hot.parents
2019,1,WCR2019_0996,2,WCR2019_0223,WCR2019_0279,within-group subordinate,within-group subordinate,369,311,58,45,25,356,336,1,99999,6059,8262,6006,0.104241552839684,0,0,NA,NA,none,hothiphop.parents,hot.parents
2019,1,WCR2019_0996,3,WCR2019_0223,WCR2019_0327,within-group subordinate,within-group subordinate,385,333,52,45,33,378,366,1,99999,6059,8195,5973,0.104241552839684,0,0,NA,NA,none,hothiphop.parents,hot.parents
2019,1,WCR2019_0997,1,WCR2019_0337,WCR2019_0405,within-group subordinate,within-group subordinate,134,3,131,63,75,66,78,1,99999,7349,7258,7203,0.13290113452188,0,0,NA,NA,none,hothiphop.parents,hot.parents
2019,1,WCR2019_0997,2,WCR2019_0337,WCR2019_0088,within-group subordinate,within-group subordinate,136,53,83,63,30,116,83,1,99999,7349,6603,6550,0.13290113452188,0,0,NA,NA,none,hothiphop.parents,hot.parents
2019,1,WCR2019_0997,3,WCR2019_0337,WCR2019_0122,within-group subordinate,within-group subordinate,143,59,84,63,21,122,80,1,99999,7349,7345,7291,0.13290113452188,0,0,NA,NA,none,hothiphop.parents,hot.parents
2019,1,WCR2019_1000,1,WCR2019_0263,WCR2019_0461,within-group subordinate,within-group subordinate,123,103,20,14,6,117,109,1,99999,8151,8166,8114,0.157381445812508,0,0,NA,NA,none,hothiphop.parents,hot.parents
2019,1,WCR2019_1000,2,WCR2019_0441,WCR2019_0461,within-group subordinate,within-group subordinate,124,100,24,18,6,118,106,1,99999,8180,8166,8143,0.157381445812508,0,0,NA,NA,none,hothiphop.parents,hot.parents
2019,1,WCR2019_1000,3,WCR2019_0256,WCR2019_0461,within-group subordinate,within-group subordinate,133,110,23,18,6,128,116,1,99999,8141,8166,8109,0.157381445812508,0,0,NA,NA,none,hothiphop.parents,hot.parents
2019,1,WCR2019_1001,1,WCR2019_0223,WCR2019_0641,within-group subordinate,within-group subordinate,290,241,49,40,57,281,298,1,99999,6081,6178,4567,0.136645962732919,0,0,NA,NA,none,hothiphop.parents,hot.parents
2019,1,WCR2019_1001,2,WCR2019_0223,WCR2019_0327,within-group subordinate,within-group subordinate,328,283,45,40,26,323,309,1,99999,6081,8221,5995,0.136645962732919,0,0,NA,NA,none,hothiphop.parents,hot.parents
2019,1,WCR2019_1001,3,WCR2019_0223,WCR2019_0088,within-group subordinate,within-group subordinate,336,263,73,40,85,303,348,1,99999,6081,7398,5359,0.136645962732919,0,0,NA,NA,none,hothiphop.parents,hot.parents
2019,1,WCR2019_1003,1,WCR2019_0223,WCR2019_0516,within-group subordinate,within-group subordinate,263,209,54,50,10,259,219,1,99999,6061,8302,6031,0.101640129294864,0,0,NA,NA,none,hothiphop.parents,hot.parents
2019,1,WCR2019_1003,2,WCR2019_0309,WCR2019_0516,within-group subordinate,within-group subordinate,295,234,61,55,10,289,244,1,99999,8285,8302,8235,0.101640129294864,0,0,NA,NA,none,hothiphop.parents,hot.parents
2019,1,WCR2019_1003,3,WCR2019_0440,WCR2019_0516,within-group subordinate,within-group subordinate,300,243,57,54,10,297,253,1,99999,6945,8302,6904,0.101640129294864,0,0,NA,NA,none,hothiphop.parents,hot.parents
2019,1,WCR2019_1005,1,WCR2019_0223,WCR2019_0641,within-group subordinate,within-group subordinate,306,251,55,36,58,287,309,1,99999,6072,6173,4558,0.140040626120206,0,0,NA,NA,none,hothiphop.parents,hot.parents
2019,1,WCR2019_1005,2,WCR2019_0223,WCR2019_0075,within-group subordinate,within-group subordinate,344,298,46,36,39,334,337,1,99999,6072,7823,5640,0.140040626120206,0,0,NA,NA,none,hothiphop.parents,hot.parents
2019,1,WCR2019_1005,3,WCR2019_0208,WCR2019_0641,within-group subordinate,within-group subordinate,347,274,73,43,58,317,332,1,99999,8277,6173,6111,0.140040626120206,0,0,NA,NA,none,hothiphop.parents,hot.parents
2019,1,WCR2019_1008,1,WCR2019_0223,WCR2019_0641,within-group subordinate,within-group subordinate,218,190,28,24,10,214,200,1,99999,6066,6169,4555,0.172587011123071,0,0,NA,NA,none,hothiphop.parents,hot.parents
2019,1,WCR2019_1008,2,WCR2019_0223,WCR2019_0075,within-group subordinate,within-group subordinate,237,212,25,24,4,236,216,1,99999,6066,7815,5634,0.172587011123071,0,0,NA,NA,none,hothiphop.parents,hot.parents
2019,1,WCR2019_1008,3,WCR2019_0008,WCR2019_0641,within-group subordinate,within-group subordinate,240,229,11,5,10,234,239,1,99999,8224,6169,6082,0.172587011123071,0,0,NA,NA,none,hothiphop.parents,hot.parents
2019,1,WCR2019_1010,1,WCR2019_0223,WCR2019_0641,within-group subordinate,within-group subordinate,360,257,103,74,124,331,381,1,99999,6039,6141,4536,0.0993512734262374,0,0,NA,NA,none,hothiphop.parents,hot.parents
2019,1,WCR2019_1010,2,WCR2019_0126,WCR2019_0641,within-group subordinate,within-group subordinate,380,229,151,161,124,390,353,1,99999,5286,6141,3944,0.0993512734262374,0,0,NA,NA,none,hothiphop.parents,hot.parents
2019,1,WCR2019_1010,3,WCR2019_0223,WCR2019_0087,within-group subordinate,within-group subordinate,391,299,92,74,88,373,387,1,99999,6039,7277,5253,0.0993512734262374,0,0,NA,NA,none,hothiphop.parents,hot.parents
2019,1,WCR2019_1011,1,WCR2019_0223,WCR2019_0516,within-group subordinate,within-group subordinate,261,204,57,56,2,260,206,1,99999,6061,8307,6031,0.0957281321048223,0,0,NA,NA,none,hothiphop.parents,hot.parents
2019,1,WCR2019_1011,2,WCR2019_0440,WCR2019_0516,within-group subordinate,within-group subordinate,281,217,64,63,2,280,219,1,99999,6946,8307,6905,0.0957281321048223,0,0,NA,NA,none,hothiphop.parents,hot.parents
2019,1,WCR2019_1011,3,WCR2019_0008,WCR2019_0516,within-group subordinate,within-group subordinate,289,240,49,48,2,288,242,1,99999,8221,8307,8172,0.0957281321048223,0,0,NA,NA,none,hothiphop.parents,hot.parents
2019,1,WCR2019_1012,1,WCR2019_0223,WCR2019_0641,within-group subordinate,within-group subordinate,207,183,24,33,25,216,208,1,99999,6073,6174,4560,0.161787549289043,0,0,NA,NA,none,hothiphop.parents,hot.parents
2019,1,WCR2019_1012,2,WCR2019_0223,WCR2019_0088,within-group subordinate,within-group subordinate,250,221,29,33,13,254,234,1,99999,6073,7400,5355,0.161787549289043,0,0,NA,NA,none,hothiphop.parents,hot.parents
2019,1,WCR2019_1012,3,WCR2019_0223,WCR2019_0122,within-group subordinate,within-group subordinate,254,221,33,33,9,254,230,1,99999,6073,8303,6023,0.161787549289043,0,0,NA,NA,none,hothiphop.parents,hot.parents
2019,1,WCR2019_1013,1,WCR2019_0223,WCR2019_0641,within-group subordinate,within-group subordinate,273,223,50,36,48,259,271,1,99999,6034,6142,4535,0.119663259170174,0,0,NA,NA,none,hothiphop.parents,hot.parents
2019,1,WCR2019_1013,2,WCR2019_0440,WCR2019_0641,within-group subordinate,within-group subordinate,303,251,52,25,48,276,299,1,99999,6910,6142,5148,0.119663259170174,0,0,NA,NA,none,hothiphop.parents,hot.parents
2019,1,WCR2019_1013,3,WCR2019_0223,WCR2019_0327,within-group subordinate,within-group subordinate,308,271,37,36,6,307,277,1,99999,6034,8164,5948,0.119663259170174,0,0,NA,NA,none,hothiphop.parents,hot.parents
2019,1,WCR2019_1014,1,WCR2019_0420,WCR2019_0325,within-group subordinate,within-group subordinate,6,2,4,3,1,5,3,1,99999,7952,7923,7911,0.0318815112338396,0,0,NA,NA,none,hothiphop.parents,hot.parents
2019,1,WCR2019_1014,2,WCR2019_0474,WCR2019_0325,within-group subordinate,within-group subordinate,45,32,13,13,1,45,33,1,99999,7670,7923,7630,0.0318815112338396,0,0,NA,NA,none,hothiphop.parents,hot.parents
2019,1,WCR2019_1014,3,WCR2019_0064,WCR2019_0325,within-group subordinate,within-group subordinate,55,41,14,14,1,55,42,1,99999,7036,7923,6996,0.0318815112338396,0,0,NA,NA,none,hothiphop.parents,hot.parents
2019,1,WCR2019_1015,1,WCR2019_0223,WCR2019_0087,within-group subordinate,within-group subordinate,367,299,68,58,54,357,353,1,99999,6065,7304,5273,0.0983253588516746,0,0,NA,NA,none,hothiphop.parents,hot.parents
2019,1,WCR2019_1015,2,WCR2019_0223,WCR2019_0641,within-group subordinate,within-group subordinate,380,283,97,58,100,341,383,1,99999,6065,6169,4556,0.0983253588516746,0,0,NA,NA,none,hothiphop.parents,hot.parents
2019,1,WCR2019_1015,3,WCR2019_0223,WCR2019_0171,within-group subordinate,within-group subordinate,406,326,80,58,69,384,395,1,99999,6065,8214,5953,0.0983253588516746,0,0,NA,NA,none,hothiphop.parents,hot.parents
2019,1,WCR2019_1016,1,WCR2019_0126,WCR2019_0641,within-group subordinate,within-group subordinate,364,231,133,128,100,359,331,1,99999,5303,6162,3955,0.0958936908895008,0,0,NA,NA,none,hothiphop.parents,hot.parents
2019,1,WCR2019_1016,2,WCR2019_0223,WCR2019_0641,within-group subordinate,within-group subordinate,365,270,95,52,100,322,370,1,99999,6059,6162,4549,0.0958936908895008,0,0,NA,NA,none,hothiphop.parents,hot.parents
2019,1,WCR2019_1016,3,WCR2019_0223,WCR2019_0087,within-group subordinate,within-group subordinate,371,305,66,52,50,357,355,1,99999,6059,7291,5262,0.0958936908895008,0,0,NA,NA,none,hothiphop.parents,hot.parents
2019,1,WCR2019_1017,1,WCR2019_0474,WCR2019_0088,within-group subordinate,within-group subordinate,107,78,29,20,21,98,99,1,99999,7967,7354,7062,0.0254094412331407,0,0,NA,NA,none,hothiphop.parents,hot.parents
2019,1,WCR2019_1017,2,WCR2019_0474,WCR2019_0398,within-group subordinate,within-group subordinate,108,70,38,20,26,90,96,1,99999,7967,8276,7939,0.0254094412331407,0,0,NA,NA,none,hothiphop.parents,hot.parents
2019,1,WCR2019_1017,3,WCR2019_0505,WCR2019_0088,within-group subordinate,within-group subordinate,109,68,41,30,21,98,89,1,99999,8246,7354,7303,0.0254094412331407,0,0,NA,NA,none,hothiphop.parents,hot.parents
2019,1,WCR2019_1018,1,WCR2019_0223,WCR2019_0047,within-group subordinate,within-group subordinate,253,206,47,45,5,251,211,1,99999,5981,8243,5973,0.125893614443233,0,0,NA,NA,none,hothiphop.parents,hot.parents
2019,1,WCR2019_1018,2,WCR2019_0223,WCR2019_0641,within-group subordinate,within-group subordinate,290,229,61,45,58,274,287,1,99999,5981,6083,4489,0.125893614443233,0,0,NA,NA,none,hothiphop.parents,hot.parents
2019,1,WCR2019_1018,3,WCR2019_0440,WCR2019_0047,within-group subordinate,within-group subordinate,297,243,54,52,5,295,248,1,99999,6858,8243,6849,0.125893614443233,0,0,NA,NA,none,hothiphop.parents,hot.parents
2019,1,WCR2019_1019,1,WCR2019_0403,WCR2019_0641,within-group subordinate,within-group subordinate,269,226,43,2,44,228,270,1,99999,8214,6144,6064,0.148223715794527,0,0,NA,NA,none,hothiphop.parents,hot.parents
2019,1,WCR2019_1019,2,WCR2019_0403,WCR2019_0327,within-group subordinate,within-group subordinate,277,261,16,2,17,263,278,1,99999,8214,8182,8065,0.148223715794527,0,0,NA,NA,none,hothiphop.parents,hot.parents
2019,1,WCR2019_1019,3,WCR2019_0403,WCR2019_0122,within-group subordinate,within-group subordinate,290,270,20,2,21,272,291,1,99999,8214,8266,8148,0.148223715794527,0,0,NA,NA,none,hothiphop.parents,hot.parents
2019,1,WCR2019_1020,1,WCR2019_0212,WCR2019_0206,within-group subordinate,within-group subordinate,14,5,9,4,5,9,10,1,99999,8303,8297,8236,0.153597896246713,0,0,NA,NA,none,hothiphop.parents,hot.parents
2019,1,WCR2019_1020,2,WCR2019_0077,WCR2019_0206,within-group subordinate,within-group subordinate,169,133,36,33,5,166,138,1,99999,8322,8297,8253,0.153597896246713,0,0,NA,NA,none,hothiphop.parents,hot.parents
2019,1,WCR2019_1020,3,WCR2019_0212,WCR2019_0327,within-group subordinate,within-group subordinate,174,158,16,4,12,162,170,1,99999,8303,8216,8159,0.153597896246713,0,0,NA,NA,none,hothiphop.parents,hot.parents
2019,1,WCR2019_1021,1,WCR2019_0505,WCR2019_0088,within-group subordinate,within-group subordinate,116,79,37,27,18,106,97,1,99999,8280,7368,7315,0.0281774580335731,0,0,NA,NA,none,hothiphop.parents,hot.parents
2019,1,WCR2019_1021,2,WCR2019_0256,WCR2019_0405,within-group subordinate,within-group subordinate,117,84,33,20,22,104,106,1,99999,8277,8177,8115,0.0281774580335731,0,0,NA,NA,none,hothiphop.parents,hot.parents
2019,1,WCR2019_1021,3,WCR2019_0474,WCR2019_0645,within-group subordinate,within-group subordinate,118,89,29,15,23,104,112,1,99999,8006,8323,7989,0.0281774580335731,0,0,NA,NA,none,hothiphop.parents,hot.parents
2019,1,WCR2019_1022,1,WCR2019_0256,WCR2019_0398,within-group subordinate,within-group subordinate,102,66,36,21,19,87,85,1,99999,8187,8218,8159,0.0252212925912453,0,0,NA,NA,none,hothiphop.parents,hot.parents
2019,1,WCR2019_1022,2,WCR2019_0409,WCR2019_0405,within-group subordinate,within-group subordinate,104,75,29,17,18,92,93,1,99999,8217,8084,8056,0.0252212925912453,0,0,NA,NA,none,hothiphop.parents,hot.parents
2019,1,WCR2019_1022,3,WCR2019_0505,WCR2019_0206,within-group subordinate,within-group subordinate,104,74,30,21,15,95,89,1,99999,8190,8181,8127,0.0252212925912453,0,0,NA,NA,none,hothiphop.parents,hot.parents
2019,1,WCR2019_1023,1,WCR2019_0223,WCR2019_0641,within-group subordinate,within-group subordinate,343,259,84,57,82,316,341,1,99999,6067,6164,4557,0.103279080899952,0,0,NA,NA,none,hothiphop.parents,hot.parents
2019,1,WCR2019_1023,2,WCR2019_0126,WCR2019_0641,within-group subordinate,within-group subordinate,372,244,128,125,82,369,326,1,99999,5300,6164,3953,0.103279080899952,0,0,NA,NA,none,hothiphop.parents,hot.parents
2019,1,WCR2019_1023,3,WCR2019_0223,WCR2019_0327,within-group subordinate,within-group subordinate,383,316,67,57,40,373,356,1,99999,6067,8207,5982,0.103279080899952,0,0,NA,NA,none,hothiphop.parents,hot.parents
2019,1,WCR2019_1024,1,WCR2019_0536,WCR2019_0463,within-group subordinate,within-group subordinate,23,14,9,5,4,19,18,1,99999,8236,8306,8221,0.122220886912631,0,0,NA,NA,none,hothiphop.parents,hot.parents
2019,1,WCR2019_1024,2,WCR2019_0536,WCR2019_0039,within-group subordinate,within-group subordinate,208,171,37,5,33,176,204,1,99999,8236,8196,8113,0.122220886912631,0,0,NA,NA,none,hothiphop.parents,hot.parents
2019,1,WCR2019_1024,3,WCR2019_0536,WCR2019_0122,within-group subordinate,within-group subordinate,226,183,43,5,39,188,222,1,99999,8236,8256,8172,0.122220886912631,0,0,NA,NA,none,hothiphop.parents,hot.parents
2019,1,WCR2019_1026,1,WCR2019_0409,WCR2019_0634,within-group subordinate,within-group subordinate,107,69,38,19,27,88,96,1,99999,8295,8290,8261,0.0260660660660661,0,0,NA,NA,none,hothiphop.parents,hot.parents
2019,1,WCR2019_1026,2,WCR2019_0409,WCR2019_0388,within-group subordinate,within-group subordinate,110,68,42,19,27,87,95,1,99999,8295,8302,8274,0.0260660660660661,0,0,NA,NA,none,hothiphop.parents,hot.parents
2019,1,WCR2019_1026,3,WCR2019_0409,WCR2019_0617,within-group subordinate,within-group subordinate,111,76,35,19,23,95,99,1,99999,8295,8305,8276,0.0260660660660661,0,0,NA,NA,none,hothiphop.parents,hot.parents
2019,1,WCR2019_1027,1,WCR2019_0223,WCR2019_0641,within-group subordinate,within-group subordinate,362,280,82,49,89,329,369,1,99999,6049,6151,4539,0.107395421311279,0,0,NA,NA,none,hothiphop.parents,hot.parents
2019,1,WCR2019_1027,2,WCR2019_0223,WCR2019_0087,within-group subordinate,within-group subordinate,379,316,63,49,54,365,370,1,99999,6049,7288,5258,0.107395421311279,0,0,NA,NA,none,hothiphop.parents,hot.parents
2019,1,WCR2019_1027,3,WCR2019_0223,WCR2019_0327,within-group subordinate,within-group subordinate,384,330,54,49,31,379,361,1,99999,6049,8192,5963,0.107395421311279,0,0,NA,NA,none,hothiphop.parents,hot.parents
2019,1,WCR2019_1028,1,WCR2019_0420,WCR2019_0325,within-group subordinate,within-group subordinate,8,2,6,2,4,4,6,1,99999,8310,8280,8267,0.0481681681681682,0,0,NA,NA,none,hothiphop.parents,hot.parents
2019,1,WCR2019_1028,2,WCR2019_0474,WCR2019_0325,within-group subordinate,within-group subordinate,52,35,17,13,4,48,39,1,99999,7988,8280,7947,0.0481681681681682,0,0,NA,NA,none,hothiphop.parents,hot.parents
2019,1,WCR2019_1028,3,WCR2019_0420,WCR2019_0592,within-group subordinate,within-group subordinate,57,25,32,2,30,27,55,1,99999,8310,8294,8281,0.0481681681681682,0,0,NA,NA,none,hothiphop.parents,hot.parents
2019,1,WCR2019_1029,1,WCR2019_0223,WCR2019_0641,within-group subordinate,within-group subordinate,299,250,49,35,57,285,307,1,99999,6068,6171,4557,0.113090257023311,0,0,NA,NA,none,hothiphop.parents,hot.parents
2019,1,WCR2019_1029,2,WCR2019_0223,WCR2019_0327,within-group subordinate,within-group subordinate,339,297,42,35,29,332,326,1,99999,6068,8214,5982,0.113090257023311,0,0,NA,NA,none,hothiphop.parents,hot.parents
2019,1,WCR2019_1029,3,WCR2019_0223,WCR2019_0122,within-group subordinate,within-group subordinate,344,296,48,35,32,331,328,1,99999,6068,8299,6018,0.113090257023311,0,0,NA,NA,none,hothiphop.parents,hot.parents
2019,1,WCR2019_1030,1,WCR2019_0223,WCR2019_0641,within-group subordinate,within-group subordinate,384,295,89,53,97,348,392,1,99999,6065,6163,4551,0.0995334370139969,0,0,NA,NA,none,hothiphop.parents,hot.parents
2019,1,WCR2019_1030,2,WCR2019_0223,WCR2019_0087,within-group subordinate,within-group subordinate,387,324,63,53,49,377,373,1,99999,6065,7302,5272,0.0995334370139969,0,0,NA,NA,none,hothiphop.parents,hot.parents
2019,1,WCR2019_1030,3,WCR2019_0223,WCR2019_0327,within-group subordinate,within-group subordinate,408,346,62,53,40,399,386,1,99999,6065,8208,5979,0.0995334370139969,0,0,NA,NA,none,hothiphop.parents,hot.parents
2019,1,WCR2019_1076,1,WCR2019_0223,WCR2019_0451,within-group subordinate,within-group subordinate,266,219,47,36,23,255,242,1,99999,6071,8332,6050,0.142327915869981,0,0,NA,NA,none,hothiphop.parents,hot.parents
2019,1,WCR2019_1076,2,WCR2019_0440,WCR2019_0451,within-group subordinate,within-group subordinate,281,210,71,61,23,271,233,1,99999,6956,8332,6929,0.142327915869981,0,0,NA,NA,none,hothiphop.parents,hot.parents
2019,1,WCR2019_1076,3,WCR2019_0223,WCR2019_0641,within-group subordinate,within-group subordinate,287,232,55,36,53,268,285,1,99999,6071,6171,4556,0.142327915869981,0,0,NA,NA,none,hothiphop.parents,hot.parents
2019,1,WCR2019_1078,1,WCR2019_0420,WCR2019_0405,within-group subordinate,within-group subordinate,4,4,0,0,0,4,4,1,99999,8240,8094,8079,0.0226501937984496,0,0,NA,NA,none,hothiphop.parents,hot.parents
2019,1,WCR2019_1078,2,WCR2019_0474,WCR2019_0405,within-group subordinate,within-group subordinate,57,45,12,12,0,57,45,1,99999,7923,8094,7778,0.0226501937984496,0,0,NA,NA,none,hothiphop.parents,hot.parents
2019,1,WCR2019_1078,3,WCR2019_0064,WCR2019_0405,within-group subordinate,within-group subordinate,66,46,20,20,0,66,46,1,99999,7211,8094,7092,0.0226501937984496,0,0,NA,NA,none,hothiphop.parents,hot.parents
2019,1,WCR2019_1079,1,WCR2019_0223,WCR2019_0641,within-group subordinate,within-group subordinate,374,301,73,44,79,345,380,1,99999,5977,6068,4481,0.0988463873709775,0,0,NA,NA,none,hothiphop.parents,hot.parents
2019,1,WCR2019_1079,2,WCR2019_0126,WCR2019_0641,within-group subordinate,within-group subordinate,395,267,128,130,79,397,346,1,99999,5238,6068,3905,0.0988463873709775,0,0,NA,NA,none,hothiphop.parents,hot.parents
2019,1,WCR2019_1079,3,WCR2019_0223,WCR2019_0087,within-group subordinate,within-group subordinate,404,339,65,44,60,383,399,1,99999,5977,7204,5205,0.0988463873709775,0,0,NA,NA,none,hothiphop.parents,hot.parents
2019,1,WCR2019_1080,1,WCR2019_0178,WCR2019_0327,within-group subordinate,within-group subordinate,290,243,47,3,45,246,288,1,99999,8272,8156,8121,0.0970266040688576,0,0,NA,NA,none,hothiphop.parents,hot.parents
2019,1,WCR2019_1080,2,WCR2019_0178,WCR2019_0641,within-group subordinate,within-group subordinate,301,194,107,3,106,197,300,1,99999,8272,6126,6100,0.0970266040688576,0,0,NA,NA,none,hothiphop.parents,hot.parents
2019,1,WCR2019_1080,3,WCR2019_0223,WCR2019_0281,within-group subordinate,within-group subordinate,302,249,53,47,27,296,276,1,99999,6027,8243,5984,0.0970266040688576,0,0,NA,NA,none,hothiphop.parents,hot.parents
2019,1,WCR2019_1081,1,WCR2019_0223,WCR2019_0641,within-group subordinate,within-group subordinate,366,285,81,52,85,337,370,1,99999,6044,6151,4541,0.093690019193858,0,0,NA,NA,none,hothiphop.parents,hot.parents
2019,1,WCR2019_1081,2,WCR2019_0126,WCR2019_0641,within-group subordinate,within-group subordinate,395,257,138,146,85,403,342,1,99999,5291,6151,3950,0.093690019193858,0,0,NA,NA,none,hothiphop.parents,hot.parents
2019,1,WCR2019_1081,3,WCR2019_0223,WCR2019_0087,within-group subordinate,within-group subordinate,397,328,69,52,66,380,394,1,99999,6044,7285,5258,0.093690019193858,0,0,NA,NA,none,hothiphop.parents,hot.parents
2019,1,WCR2019_1082,1,WCR2019_0223,WCR2019_0641,within-group subordinate,within-group subordinate,275,223,52,27,64,250,287,1,99999,6063,6162,4551,0.14588319770225,0,0,NA,NA,none,hothiphop.parents,hot.parents
2019,1,WCR2019_1082,2,WCR2019_0482,WCR2019_0327,within-group subordinate,within-group subordinate,290,248,42,27,24,275,272,1,99999,8252,8205,8102,0.14588319770225,0,0,NA,NA,none,hothiphop.parents,hot.parents
2019,1,WCR2019_1082,3,WCR2019_0223,WCR2019_0327,within-group subordinate,within-group subordinate,298,267,31,27,24,294,291,1,99999,6063,8205,5977,0.14588319770225,0,0,NA,NA,none,hothiphop.parents,hot.parents
2019,1,WCR2019_1083,1,WCR2019_0223,WCR2019_0641,within-group subordinate,within-group subordinate,289,234,55,40,62,274,296,1,99999,6064,6168,4556,0.143763466602825,0,0,NA,NA,none,hothiphop.parents,hot.parents
2019,1,WCR2019_1083,2,WCR2019_0555,WCR2019_0641,within-group subordinate,within-group subordinate,304,239,65,5,62,244,301,1,99999,8302,6168,6133,0.143763466602825,0,0,NA,NA,none,hothiphop.parents,hot.parents
2019,1,WCR2019_1083,3,WCR2019_0220,WCR2019_0641,within-group subordinate,within-group subordinate,307,234,73,35,62,269,296,1,99999,8178,6168,6038,0.143763466602825,0,0,NA,NA,none,hothiphop.parents,hot.parents
2019,1,WCR2019_1084,1,WCR2019_0223,WCR2019_0641,within-group subordinate,within-group subordinate,226,201,25,22,11,223,212,1,99999,6073,6177,4562,0.17722275334608,0,0,NA,NA,none,hothiphop.parents,hot.parents
2019,1,WCR2019_1084,2,WCR2019_0223,WCR2019_0088,within-group subordinate,within-group subordinate,233,216,17,22,3,238,219,1,99999,6073,7394,5351,0.17722275334608,0,0,NA,NA,none,hothiphop.parents,hot.parents
2019,1,WCR2019_1084,3,WCR2019_0223,WCR2019_0075,within-group subordinate,within-group subordinate,244,222,22,22,2,244,224,1,99999,6073,7821,5639,0.17722275334608,0,0,NA,NA,none,hothiphop.parents,hot.parents
2019,1,WCR2019_1085,1,WCR2019_0532,WCR2019_0327,within-group subordinate,within-group subordinate,297,265,32,2,31,267,296,1,99999,8289,8201,8142,0.0929230032331457,0,0,NA,NA,none,hothiphop.parents,hot.parents
2019,1,WCR2019_1085,2,WCR2019_0532,WCR2019_0122,within-group subordinate,within-group subordinate,304,255,49,2,49,257,304,1,99999,8289,8286,8225,0.0929230032331457,0,0,NA,NA,none,hothiphop.parents,hot.parents
2019,1,WCR2019_1085,3,WCR2019_0532,WCR2019_0087,within-group subordinate,within-group subordinate,304,249,55,2,55,251,304,1,99999,8289,7291,7235,0.0929230032331457,0,0,NA,NA,none,hothiphop.parents,hot.parents
2019,1,WCR2019_1087,1,WCR2019_0420,WCR2019_0405,within-group subordinate,within-group subordinate,3,1,2,1,1,2,2,1,99999,8338,8185,8172,0.0219109195402299,0,0,NA,NA,none,hothiphop.parents,hot.parents
2019,1,WCR2019_1087,2,WCR2019_0474,WCR2019_0405,within-group subordinate,within-group subordinate,56,41,15,15,1,56,42,1,99999,8013,8185,7864,0.0219109195402299,0,0,NA,NA,none,hothiphop.parents,hot.parents
2019,1,WCR2019_1087,3,WCR2019_0064,WCR2019_0405,within-group subordinate,within-group subordinate,63,45,18,18,1,63,46,1,99999,7284,8185,7160,0.0219109195402299,0,0,NA,NA,none,hothiphop.parents,hot.parents
2019,1,WCR2019_1088,1,WCR2019_0223,WCR2019_0641,within-group subordinate,within-group subordinate,274,220,54,41,59,261,279,1,99999,6068,6169,4556,0.135597273705608,0,0,NA,NA,none,hothiphop.parents,hot.parents
2019,1,WCR2019_1088,2,WCR2019_0310,WCR2019_0641,within-group subordinate,within-group subordinate,330,264,66,24,59,288,323,1,99999,8322,6169,6144,0.135597273705608,0,0,NA,NA,none,hothiphop.parents,hot.parents
2019,1,WCR2019_1088,3,WCR2019_0223,WCR2019_0161,within-group subordinate,within-group subordinate,342,296,46,41,28,337,324,1,99999,6068,8229,5973,0.135597273705608,0,0,NA,NA,none,hothiphop.parents,hot.parents
2019,1,WCR2019_1091,1,WCR2019_0008,WCR2019_0150,within-group subordinate,within-group subordinate,293,254,39,36,4,290,258,1,99999,8126,8232,8103,0.112887596899225,0,0,NA,NA,none,hothiphop.parents,hot.parents
2019,1,WCR2019_1091,2,WCR2019_0267,WCR2019_0150,within-group subordinate,within-group subordinate,302,249,53,49,4,298,253,1,99999,8195,8232,8172,0.112887596899225,0,0,NA,NA,none,hothiphop.parents,hot.parents
2019,1,WCR2019_1091,3,WCR2019_0223,WCR2019_0150,within-group subordinate,within-group subordinate,304,239,65,62,4,301,243,1,99999,5976,8232,5957,0.112887596899225,0,0,NA,NA,none,hothiphop.parents,hot.parents
2019,1,WCR2019_1092,1,WCR2019_0008,WCR2019_0313,within-group subordinate,within-group subordinate,223,195,28,21,9,216,204,1,99999,8225,8307,8174,0.143797104916856,0,0,NA,NA,none,hothiphop.parents,hot.parents
2019,1,WCR2019_1092,2,WCR2019_0165,WCR2019_0313,within-group subordinate,within-group subordinate,227,195,32,25,9,220,204,1,99999,8336,8307,8284,0.143797104916856,0,0,NA,NA,none,hothiphop.parents,hot.parents
2019,1,WCR2019_1092,3,WCR2019_0440,WCR2019_0313,within-group subordinate,within-group subordinate,227,177,50,45,9,222,186,1,99999,6949,8307,6904,0.143797104916856,0,0,NA,NA,none,hothiphop.parents,hot.parents
2019,1,WCR2019_1093,1,WCR2019_0223,WCR2019_0641,within-group subordinate,within-group subordinate,321,244,77,54,77,298,321,1,99999,6023,6136,4528,0.0988204140587386,0,0,NA,NA,none,hothiphop.parents,hot.parents
2019,1,WCR2019_1093,2,WCR2019_0223,WCR2019_0327,within-group subordinate,within-group subordinate,337,277,60,54,45,331,322,1,99999,6023,8159,5939,0.0988204140587386,0,0,NA,NA,none,hothiphop.parents,hot.parents
2019,1,WCR2019_1093,3,WCR2019_0223,WCR2019_0087,within-group subordinate,within-group subordinate,351,272,79,54,77,326,349,1,99999,6023,7264,5241,0.0988204140587386,0,0,NA,NA,none,hothiphop.parents,hot.parents
2019,1,WCR2019_1094,1,WCR2019_0223,WCR2019_0641,within-group subordinate,within-group subordinate,352,269,83,52,101,321,370,1,99999,6050,6155,4540,0.105200095854301,0,0,NA,NA,none,hothiphop.parents,hot.parents
2019,1,WCR2019_1094,2,WCR2019_0223,WCR2019_0327,within-group subordinate,within-group subordinate,361,302,59,52,41,354,343,1,99999,6050,8195,5964,0.105200095854301,0,0,NA,NA,none,hothiphop.parents,hot.parents
2019,1,WCR2019_1094,3,WCR2019_0223,WCR2019_0087,within-group subordinate,within-group subordinate,362,295,67,52,61,347,356,1,99999,6050,7292,5261,0.105200095854301,0,0,NA,NA,none,hothiphop.parents,hot.parents
2019,1,WCR2019_1095,1,WCR2019_0252,WCR2019_0405,within-group subordinate,within-group subordinate,61,47,14,14,0,61,47,1,99999,8140,8026,7976,0.0269808326211696,0,0,NA,NA,none,hothiphop.parents,hot.parents
2019,1,WCR2019_1095,2,WCR2019_0256,WCR2019_0405,within-group subordinate,within-group subordinate,67,50,17,18,0,68,50,1,99999,8128,8026,7964,0.0269808326211696,0,0,NA,NA,none,hothiphop.parents,hot.parents
2019,1,WCR2019_1095,3,WCR2019_0496,WCR2019_0405,within-group subordinate,within-group subordinate,69,51,18,21,0,72,51,1,99999,8150,8026,7986,0.0269808326211696,0,0,NA,NA,none,hothiphop.parents,hot.parents
2019,1,WCR2019_1097,1,WCR2019_0223,WCR2019_0641,within-group subordinate,within-group subordinate,388,305,83,57,102,362,407,1,99999,6042,6150,4540,0.100360144057623,0,0,NA,NA,none,hothiphop.parents,hot.parents
2019,1,WCR2019_1097,2,WCR2019_0223,WCR2019_0087,within-group subordinate,within-group subordinate,391,324,67,57,54,381,378,1,99999,6042,7280,5254,0.100360144057623,0,0,NA,NA,none,hothiphop.parents,hot.parents
2019,1,WCR2019_1097,3,WCR2019_0126,WCR2019_0641,within-group subordinate,within-group subordinate,409,272,137,141,102,413,374,1,99999,5285,6150,3945,0.100360144057623,0,0,NA,NA,none,hothiphop.parents,hot.parents
2019,1,WCR2019_1098,1,WCR2019_0223,WCR2019_0641,within-group subordinate,within-group subordinate,301,224,77,48,87,272,311,1,99999,5838,5939,4382,0.0866053677932406,0,0,NA,NA,none,hothiphop.parents,hot.parents
2019,1,WCR2019_1098,2,WCR2019_0223,WCR2019_0322,within-group subordinate,within-group subordinate,337,268,69,48,47,316,315,1,99999,5838,8015,5818,0.0866053677932406,0,0,NA,NA,none,hothiphop.parents,hot.parents
2019,1,WCR2019_1098,3,WCR2019_0223,WCR2019_0327,within-group subordinate,within-group subordinate,340,288,52,48,26,336,314,1,99999,5838,7899,5753,0.0866053677932406,0,0,NA,NA,none,hothiphop.parents,hot.parents
2019,1,WCR2019_1099,1,WCR2019_0474,WCR2019_0405,within-group subordinate,within-group subordinate,60,46,14,15,0,61,46,1,99999,8013,8185,7865,0.0261046581247755,0,0,NA,NA,none,hothiphop.parents,hot.parents
2019,1,WCR2019_1099,2,WCR2019_0260,WCR2019_0405,within-group subordinate,within-group subordinate,62,49,13,15,0,64,49,1,99999,8266,8185,8103,0.0261046581247755,0,0,NA,NA,none,hothiphop.parents,hot.parents
2019,1,WCR2019_1099,3,WCR2019_0338,WCR2019_0405,within-group subordinate,within-group subordinate,65,50,15,16,0,66,50,1,99999,8327,8185,8163,0.0261046581247755,0,0,NA,NA,none,hothiphop.parents,hot.parents
2019,1,WCR2019_1100,1,WCR2019_0223,WCR2019_0641,within-group subordinate,within-group subordinate,221,189,32,27,16,216,205,1,99999,6064,6166,4557,0.173689250658367,0,0,NA,NA,none,hothiphop.parents,hot.parents
2019,1,WCR2019_1100,2,WCR2019_0473,WCR2019_0398,within-group subordinate,within-group subordinate,226,156,70,53,20,209,176,1,99999,8325,8325,8296,0.173689250658367,0,0,NA,NA,none,hothiphop.parents,hot.parents
2019,1,WCR2019_1100,3,WCR2019_0473,WCR2019_0039,within-group subordinate,within-group subordinate,231,175,56,53,8,228,183,1,99999,8325,8229,8200,0.173689250658367,0,0,NA,NA,none,hothiphop.parents,hot.parents
2019,1,WCR2019_1101,1,WCR2019_0223,WCR2019_0641,within-group subordinate,within-group subordinate,302,232,70,50,61,282,293,1,99999,6066,6164,4554,0.133484975457919,0,0,NA,NA,none,hothiphop.parents,hot.parents
2019,1,WCR2019_1101,2,WCR2019_0126,WCR2019_0641,within-group subordinate,within-group subordinate,318,205,113,123,61,328,266,1,99999,5298,6164,3953,0.133484975457919,0,0,NA,NA,none,hothiphop.parents,hot.parents
2019,1,WCR2019_1101,3,WCR2019_0440,WCR2019_0641,within-group subordinate,within-group subordinate,321,247,74,47,61,294,308,1,99999,6945,6164,5169,0.133484975457919,0,0,NA,NA,none,hothiphop.parents,hot.parents
2019,1,WCR2019_1102,1,WCR2019_0260,WCR2019_0405,within-group subordinate,within-group subordinate,63,45,18,20,0,65,45,1,99999,8172,8095,8013,0.023976749818358,0,0,NA,NA,none,hothiphop.parents,hot.parents
2019,1,WCR2019_1102,2,WCR2019_0334,WCR2019_0405,within-group subordinate,within-group subordinate,66,49,17,20,0,69,49,1,99999,8244,8095,8081,0.023976749818358,0,0,NA,NA,none,hothiphop.parents,hot.parents
2019,1,WCR2019_1102,3,WCR2019_0474,WCR2019_0405,within-group subordinate,within-group subordinate,66,46,20,20,0,66,46,1,99999,7924,8095,7778,0.023976749818358,0,0,NA,NA,none,hothiphop.parents,hot.parents
2019,1,WCR2019_1104,1,WCR2019_0421,WCR2019_0388,within-group subordinate,within-group subordinate,10,3,7,3,4,6,7,1,99999,8352,8347,8331,0.120339388145315,0,0,NA,NA,none,hothiphop.parents,hot.parents
2019,1,WCR2019_1104,2,WCR2019_0421,WCR2019_0088,within-group subordinate,within-group subordinate,64,49,15,3,12,52,61,1,99999,8352,7395,7379,0.120339388145315,0,0,NA,NA,none,hothiphop.parents,hot.parents
2019,1,WCR2019_1104,3,WCR2019_0421,WCR2019_0122,within-group subordinate,within-group subordinate,79,59,20,3,17,62,76,1,99999,8352,8302,8286,0.120339388145315,0,0,NA,NA,none,hothiphop.parents,hot.parents
2019,1,WCR2019_1105,1,WCR2019_0223,WCR2019_0216,within-group subordinate,within-group subordinate,235,178,57,54,6,232,184,1,99999,6054,8281,6018,0.102456560814859,0,0,NA,NA,none,hothiphop.parents,hot.parents
2019,1,WCR2019_1105,2,WCR2019_0440,WCR2019_0216,within-group subordinate,within-group subordinate,269,209,60,57,6,266,215,1,99999,6935,8281,6890,0.102456560814859,0,0,NA,NA,none,hothiphop.parents,hot.parents
2019,1,WCR2019_1105,3,WCR2019_0219,WCR2019_0216,within-group subordinate,within-group subordinate,279,215,64,60,6,275,221,1,99999,7563,8281,7508,0.102456560814859,0,0,NA,NA,none,hothiphop.parents,hot.parents
2019,1,WCR2019_1106,1,WCR2019_0223,WCR2019_0641,within-group subordinate,within-group subordinate,272,235,37,29,26,264,261,1,99999,6082,6186,4568,0.156865084098771,0,0,NA,NA,none,hothiphop.parents,hot.parents
2019,1,WCR2019_1106,2,WCR2019_0223,WCR2019_0075,within-group subordinate,within-group subordinate,300,256,44,29,35,285,291,1,99999,6082,7835,5648,0.156865084098771,0,0,NA,NA,none,hothiphop.parents,hot.parents
2019,1,WCR2019_1106,3,WCR2019_0223,WCR2019_0088,within-group subordinate,within-group subordinate,304,258,46,29,42,287,300,1,99999,6082,7408,5359,0.156865084098771,0,0,NA,NA,none,hothiphop.parents,hot.parents
2019,1,WCR2019_1107,1,WCR2019_0223,WCR2019_0641,within-group subordinate,within-group subordinate,282,234,48,36,51,270,285,1,99999,6067,6162,4555,0.136205864751646,0,0,NA,NA,none,hothiphop.parents,hot.parents
2019,1,WCR2019_1107,2,WCR2019_0223,WCR2019_0122,within-group subordinate,within-group subordinate,346,300,46,36,25,336,325,1,99999,6067,8289,6017,0.136205864751646,0,0,NA,NA,none,hothiphop.parents,hot.parents
2019,1,WCR2019_1107,3,WCR2019_0223,WCR2019_0327,within-group subordinate,within-group subordinate,347,306,41,36,32,342,338,1,99999,6067,8205,5981,0.136205864751646,0,0,NA,NA,none,hothiphop.parents,hot.parents
2019,1,WCR2019_1108,1,WCR2019_0223,WCR2019_0641,within-group subordinate,within-group subordinate,262,202,60,53,45,255,247,1,99999,6070,6176,4558,0.12773330146971,0,0,NA,NA,none,hothiphop.parents,hot.parents
2019,1,WCR2019_1108,2,WCR2019_0223,WCR2019_0088,within-group subordinate,within-group subordinate,296,229,67,53,57,282,286,1,99999,6070,7396,5349,0.12773330146971,0,0,NA,NA,none,hothiphop.parents,hot.parents
2019,1,WCR2019_1108,3,WCR2019_0440,WCR2019_0641,within-group subordinate,within-group subordinate,298,244,54,32,45,276,289,1,99999,6956,6176,5177,0.12773330146971,0,0,NA,NA,none,hothiphop.parents,hot.parents
2019,1,WCR2019_1109,1,WCR2019_0474,WCR2019_0405,within-group subordinate,within-group subordinate,58,48,10,10,1,58,49,1,99999,7919,8091,7772,0.0266472868217054,0,0,NA,NA,none,hothiphop.parents,hot.parents
2019,1,WCR2019_1109,2,WCR2019_0535,WCR2019_0405,within-group subordinate,within-group subordinate,66,48,18,20,1,68,49,1,99999,8232,8091,8068,0.0266472868217054,0,0,NA,NA,none,hothiphop.parents,hot.parents
2019,1,WCR2019_1109,3,WCR2019_0409,WCR2019_0405,within-group subordinate,within-group subordinate,66,47,19,21,1,68,48,1,99999,8225,8091,8062,0.0266472868217054,0,0,NA,NA,none,hothiphop.parents,hot.parents
2019,1,WCR2019_1110,1,WCR2019_0536,WCR2019_0463,within-group subordinate,within-group subordinate,15,8,7,2,5,10,13,1,99999,8274,8347,8259,0.122937096388424,0,0,NA,NA,none,hothiphop.parents,hot.parents
2019,1,WCR2019_1110,2,WCR2019_0536,WCR2019_0122,within-group subordinate,within-group subordinate,232,207,25,2,23,209,230,1,99999,8274,8296,8209,0.122937096388424,0,0,NA,NA,none,hothiphop.parents,hot.parents
2019,1,WCR2019_1110,3,WCR2019_0223,WCR2019_0463,within-group subordinate,within-group subordinate,233,195,38,34,5,229,200,1,99999,6064,8347,6055,0.122937096388424,0,0,NA,NA,none,hothiphop.parents,hot.parents
2019,1,WCR2019_1111,1,WCR2019_0420,WCR2019_0325,within-group subordinate,within-group subordinate,19,15,4,2,2,17,17,1,99999,8315,8287,8272,0.0423616944677787,0,0,NA,NA,none,hothiphop.parents,hot.parents
2019,1,WCR2019_1111,2,WCR2019_0474,WCR2019_0325,within-group subordinate,within-group subordinate,48,36,12,10,2,46,38,1,99999,7994,8287,7952,0.0423616944677787,0,0,NA,NA,none,hothiphop.parents,hot.parents
2019,1,WCR2019_1111,3,WCR2019_0256,WCR2019_0325,within-group subordinate,within-group subordinate,59,46,13,12,2,58,48,1,99999,8269,8287,8224,0.0423616944677787,0,0,NA,NA,none,hothiphop.parents,hot.parents
2019,1,WCR2019_1115,1,WCR2019_0223,WCR2019_0641,within-group subordinate,within-group subordinate,354,274,80,56,89,330,363,1,99999,6036,6149,4538,0.0938025462406918,0,0,NA,NA,none,hothiphop.parents,hot.parents
2019,1,WCR2019_1115,2,WCR2019_0126,WCR2019_0641,within-group subordinate,within-group subordinate,385,254,131,136,89,390,343,1,99999,5282,6149,3941,0.0938025462406918,0,0,NA,NA,none,hothiphop.parents,hot.parents
2019,1,WCR2019_1115,3,WCR2019_0223,WCR2019_0087,within-group subordinate,within-group subordinate,388,321,67,56,56,377,377,1,99999,6036,7278,5252,0.0938025462406918,0,0,NA,NA,none,hothiphop.parents,hot.parents
2019,1,WCR2019_1117,1,WCR2019_0481,WCR2019_0087,within-group subordinate,within-group subordinate,234,207,27,2,27,209,234,1,99999,8214,7241,7192,0.160396758195234,0,0,NA,NA,none,hothiphop.parents,hot.parents
2019,1,WCR2019_1117,2,WCR2019_0481,WCR2019_0327,within-group subordinate,within-group subordinate,257,240,17,2,15,242,255,1,99999,8214,8118,8070,0.160396758195234,0,0,NA,NA,none,hothiphop.parents,hot.parents
2019,1,WCR2019_1117,3,WCR2019_0481,WCR2019_0641,within-group subordinate,within-group subordinate,272,225,47,2,46,227,271,1,99999,8214,6112,6078,0.160396758195234,0,0,NA,NA,none,hothiphop.parents,hot.parents
2019,1,WCR2019_1118,1,WCR2019_0223,WCR2019_0641,within-group subordinate,within-group subordinate,296,237,59,60,63,297,300,1,99999,6062,6163,4550,0.128665469778576,0,0,NA,NA,none,hothiphop.parents,hot.parents
2019,1,WCR2019_1118,2,WCR2019_0223,WCR2019_0075,within-group subordinate,within-group subordinate,346,280,66,60,58,340,338,1,99999,6062,7807,5628,0.128665469778576,0,0,NA,NA,none,hothiphop.parents,hot.parents
2019,1,WCR2019_1118,3,WCR2019_0223,WCR2019_0161,within-group subordinate,within-group subordinate,353,292,61,60,38,352,330,1,99999,6062,8221,5967,0.128665469778576,0,0,NA,NA,none,hothiphop.parents,hot.parents
2019,1,WCR2019_1119,1,WCR2019_0532,WCR2019_0327,within-group subordinate,within-group subordinate,271,247,24,4,24,251,271,1,99999,8264,8178,8116,0.0977308200264137,0,0,NA,NA,none,hothiphop.parents,hot.parents
2019,1,WCR2019_1119,2,WCR2019_0532,WCR2019_0641,within-group subordinate,within-group subordinate,287,212,75,4,75,216,287,1,99999,8264,6142,6090,0.0977308200264137,0,0,NA,NA,none,hothiphop.parents,hot.parents
2019,1,WCR2019_1119,3,WCR2019_0532,WCR2019_0122,within-group subordinate,within-group subordinate,289,250,39,4,37,254,287,1,99999,8264,8264,8200,0.0977308200264137,0,0,NA,NA,none,hothiphop.parents,hot.parents
2019,1,WCR2019_1120,1,WCR2019_0223,WCR2019_0641,within-group subordinate,within-group subordinate,293,232,61,58,57,290,289,1,99999,6060,6171,4552,0.130055037090213,0,0,NA,NA,none,hothiphop.parents,hot.parents
2019,1,WCR2019_1120,2,WCR2019_0267,WCR2019_0641,within-group subordinate,within-group subordinate,295,235,60,4,57,239,292,1,99999,8297,6171,6132,0.130055037090213,0,0,NA,NA,none,hothiphop.parents,hot.parents
2019,1,WCR2019_1120,3,WCR2019_0267,WCR2019_0327,within-group subordinate,within-group subordinate,302,251,51,4,47,255,298,1,99999,8297,8207,8149,0.130055037090213,0,0,NA,NA,none,hothiphop.parents,hot.parents
2019,1,WCR2019_1122,1,WCR2019_0536,WCR2019_0463,within-group subordinate,within-group subordinate,23,8,15,10,5,18,13,1,99999,8174,8244,8160,0.114797771857593,0,0,NA,NA,none,hothiphop.parents,hot.parents
2019,1,WCR2019_1122,2,WCR2019_0536,WCR2019_0039,within-group subordinate,within-group subordinate,212,157,55,10,45,167,202,1,99999,8174,8134,8052,0.114797771857593,0,0,NA,NA,none,hothiphop.parents,hot.parents
2019,1,WCR2019_1122,3,WCR2019_0536,WCR2019_0327,within-group subordinate,within-group subordinate,216,177,39,10,33,187,210,1,99999,8174,8113,8031,0.114797771857593,0,0,NA,NA,none,hothiphop.parents,hot.parents
2019,1,WCR2019_1123,1,WCR2019_0585,WCR2019_0327,within-group subordinate,within-group subordinate,302,256,46,12,38,268,294,1,99999,8350,8222,8200,0.088618177475218,0,0,NA,NA,none,hothiphop.parents,hot.parents
2019,1,WCR2019_1123,2,WCR2019_0585,WCR2019_0122,within-group subordinate,within-group subordinate,321,251,70,12,62,263,313,1,99999,8350,8307,8284,0.088618177475218,0,0,NA,NA,none,hothiphop.parents,hot.parents
2019,1,WCR2019_1123,3,WCR2019_0585,WCR2019_0161,within-group subordinate,within-group subordinate,321,250,71,12,64,262,314,1,99999,8350,8239,8216,0.088618177475218,0,0,NA,NA,none,hothiphop.parents,hot.parents
2019,1,WCR2019_1124,1,WCR2019_0585,WCR2019_0327,within-group subordinate,within-group subordinate,279,242,37,4,35,246,277,1,99999,8330,8204,8180,0.0885697187312986,0,0,NA,NA,none,hothiphop.parents,hot.parents
2019,1,WCR2019_1124,2,WCR2019_0585,WCR2019_0087,within-group subordinate,within-group subordinate,288,224,64,4,62,228,286,1,99999,8330,7292,7269,0.0885697187312986,0,0,NA,NA,none,hothiphop.parents,hot.parents
2019,1,WCR2019_1124,3,WCR2019_0585,WCR2019_0161,within-group subordinate,within-group subordinate,289,233,56,4,53,237,286,1,99999,8330,8221,8196,0.0885697187312986,0,0,NA,NA,none,hothiphop.parents,hot.parents
2019,1,WCR2019_1125,1,WCR2019_0223,WCR2019_0258,within-group subordinate,within-group subordinate,243,204,39,39,6,243,210,1,99999,6065,8276,6022,0.142651986596458,0,0,NA,NA,none,hothiphop.parents,hot.parents
2019,1,WCR2019_1125,2,WCR2019_0223,WCR2019_0641,within-group subordinate,within-group subordinate,294,237,57,39,49,276,286,1,99999,6065,6164,4554,0.142651986596458,0,0,NA,NA,none,hothiphop.parents,hot.parents
2019,1,WCR2019_1125,3,WCR2019_0191,WCR2019_0258,within-group subordinate,within-group subordinate,310,263,47,44,6,307,269,1,99999,7065,8276,7001,0.142651986596458,0,0,NA,NA,none,hothiphop.parents,hot.parents
2019,1,WCR2019_1126,1,WCR2019_0223,WCR2019_0641,within-group subordinate,within-group subordinate,367,280,87,57,94,337,374,1,99999,6069,6170,4558,0.0923113715173981,0,0,NA,NA,none,hothiphop.parents,hot.parents
2019,1,WCR2019_1126,2,WCR2019_0223,WCR2019_0087,within-group subordinate,within-group subordinate,384,313,71,57,65,370,378,1,99999,6069,7300,5271,0.0923113715173981,0,0,NA,NA,none,hothiphop.parents,hot.parents
2019,1,WCR2019_1126,3,WCR2019_0126,WCR2019_0641,within-group subordinate,within-group subordinate,392,258,134,134,94,392,352,1,99999,5305,6170,3957,0.0923113715173981,0,0,NA,NA,none,hothiphop.parents,hot.parents
2019,1,WCR2019_1127,1,WCR2019_0008,WCR2019_0088,within-group subordinate,within-group subordinate,154,129,25,18,16,147,145,1,99999,8133,7330,7215,0.0678519593613933,0,0,NA,NA,none,hothiphop.parents,hot.parents
2019,1,WCR2019_1127,2,WCR2019_0499,WCR2019_0088,within-group subordinate,within-group subordinate,159,135,24,15,16,150,151,1,99999,8229,7330,7294,0.0678519593613933,0,0,NA,NA,none,hothiphop.parents,hot.parents
2019,1,WCR2019_1127,3,WCR2019_0282,WCR2019_0088,within-group subordinate,within-group subordinate,161,137,24,20,16,157,153,1,99999,8175,7330,7243,0.0678519593613933,0,0,NA,NA,none,hothiphop.parents,hot.parents
2019,1,WCR2019_1128,1,WCR2019_0594,WCR2019_0206,within-group subordinate,within-group subordinate,8,2,6,1,5,3,7,1,99999,8256,8215,8187,0.178899082568807,0,0,NA,NA,none,hothiphop.parents,hot.parents
2019,1,WCR2019_1128,2,WCR2019_0594,WCR2019_0122,within-group subordinate,within-group subordinate,142,132,10,1,9,133,141,1,99999,8256,8222,8194,0.178899082568807,0,0,NA,NA,none,hothiphop.parents,hot.parents
2019,1,WCR2019_1128,3,WCR2019_0594,WCR2019_0537,within-group subordinate,within-group subordinate,142,119,23,1,22,120,141,1,99999,8256,8266,8238,0.178899082568807,0,0,NA,NA,none,hothiphop.parents,hot.parents
2019,1,WCR2019_1129,1,WCR2019_0223,WCR2019_0641,within-group subordinate,within-group subordinate,280,224,56,54,44,278,268,1,99999,6071,6177,4561,0.130751762877973,0,0,NA,NA,none,hothiphop.parents,hot.parents
2019,1,WCR2019_1129,2,WCR2019_0223,WCR2019_0327,within-group subordinate,within-group subordinate,315,256,59,54,15,310,271,1,99999,6071,8216,5985,0.130751762877973,0,0,NA,NA,none,hothiphop.parents,hot.parents
2019,1,WCR2019_1129,3,WCR2019_0223,WCR2019_0075,within-group subordinate,within-group subordinate,326,257,69,54,38,311,295,1,99999,6071,7820,5637,0.130751762877973,0,0,NA,NA,none,hothiphop.parents,hot.parents
2019,1,WCR2019_1130,1,WCR2019_0223,WCR2019_0641,within-group subordinate,within-group subordinate,215,190,25,25,8,215,198,1,99999,6069,6172,4558,0.176709708273553,0,0,NA,NA,none,hothiphop.parents,hot.parents
2019,1,WCR2019_1130,2,WCR2019_0223,WCR2019_0088,within-group subordinate,within-group subordinate,240,217,23,25,2,242,219,1,99999,6069,7392,5349,0.176709708273553,0,0,NA,NA,none,hothiphop.parents,hot.parents
2019,1,WCR2019_1130,3,WCR2019_0223,WCR2019_0327,within-group subordinate,within-group subordinate,242,213,29,25,6,238,219,1,99999,6069,8213,5983,0.176709708273553,0,0,NA,NA,none,hothiphop.parents,hot.parents
2019,1,WCR2019_1131,1,WCR2019_0520,WCR2019_0327,within-group subordinate,within-group subordinate,274,234,40,5,37,239,271,1,99999,8317,8192,8168,0.105370414768641,0,0,NA,NA,none,hothiphop.parents,hot.parents
2019,1,WCR2019_1131,2,WCR2019_0520,WCR2019_0641,within-group subordinate,within-group subordinate,277,191,86,5,84,196,275,1,99999,8317,6162,6142,0.105370414768641,0,0,NA,NA,none,hothiphop.parents,hot.parents
2019,1,WCR2019_1131,3,WCR2019_0223,WCR2019_0641,within-group subordinate,within-group subordinate,283,213,70,45,84,258,297,1,99999,6050,6162,4550,0.105370414768641,0,0,NA,NA,none,hothiphop.parents,hot.parents
2019,1,WCR2019_1132,1,WCR2019_0223,WCR2019_0641,within-group subordinate,within-group subordinate,255,173,82,72,61,245,234,1,99999,6021,6123,4523,0.109625346343814,0,0,NA,NA,none,hothiphop.parents,hot.parents
2019,1,WCR2019_1132,2,WCR2019_0223,WCR2019_0075,within-group subordinate,within-group subordinate,278,195,83,72,36,267,231,1,99999,6021,7767,5599,0.109625346343814,0,0,NA,NA,none,hothiphop.parents,hot.parents
2019,1,WCR2019_1132,3,WCR2019_0223,WCR2019_0122,within-group subordinate,within-group subordinate,281,200,81,72,24,272,224,1,99999,6021,8237,5973,0.109625346343814,0,0,NA,NA,none,hothiphop.parents,hot.parents
2019,1,WCR2019_1133,1,WCR2019_0223,WCR2019_0641,within-group subordinate,within-group subordinate,355,259,96,63,112,322,371,1,99999,6036,6140,4530,0.0813408626697104,0,0,NA,NA,none,hothiphop.parents,hot.parents
2019,1,WCR2019_1133,2,WCR2019_0223,WCR2019_0087,within-group subordinate,within-group subordinate,368,281,87,63,85,344,366,1,99999,6036,7278,5254,0.0813408626697104,0,0,NA,NA,none,hothiphop.parents,hot.parents
2019,1,WCR2019_1133,3,WCR2019_0223,WCR2019_0073,within-group subordinate,within-group subordinate,377,287,90,63,84,350,371,1,99999,6036,7942,5726,0.0813408626697104,0,0,NA,NA,none,hothiphop.parents,hot.parents
2019,1,WCR2019_1134,1,WCR2019_0585,WCR2019_0087,within-group subordinate,within-group subordinate,275,222,53,6,49,228,271,1,99999,8330,7294,7271,0.0921603830041891,0,0,NA,NA,none,hothiphop.parents,hot.parents
2019,1,WCR2019_1134,2,WCR2019_0585,WCR2019_0327,within-group subordinate,within-group subordinate,296,263,33,6,30,269,293,1,99999,8330,8206,8182,0.0921603830041891,0,0,NA,NA,none,hothiphop.parents,hot.parents
2019,1,WCR2019_1134,3,WCR2019_0585,WCR2019_0641,within-group subordinate,within-group subordinate,303,203,100,6,98,209,301,1,99999,8330,6161,6140,0.0921603830041891,0,0,NA,NA,none,hothiphop.parents,hot.parents
2019,1,WCR2019_1137,1,WCR2019_0141,WCR2019_0519,within-group subordinate,within-group subordinate,181,157,24,19,10,176,167,1,99999,8254,8223,8208,0.103869407496977,0,0,NA,NA,none,hothiphop.parents,hot.parents
2019,1,WCR2019_1137,2,WCR2019_0263,WCR2019_0519,within-group subordinate,within-group subordinate,182,159,23,19,10,178,169,1,99999,8217,8223,8171,0.103869407496977,0,0,NA,NA,none,hothiphop.parents,hot.parents
2019,1,WCR2019_1137,3,WCR2019_0367,WCR2019_0519,within-group subordinate,within-group subordinate,187,153,34,29,10,182,163,1,99999,8218,8223,8171,0.103869407496977,0,0,NA,NA,none,hothiphop.parents,hot.parents
2019,1,WCR2019_1138,1,WCR2019_0421,WCR2019_0258,within-group subordinate,within-group subordinate,18,3,15,9,6,12,9,1,99999,8345,8281,8265,0.124387035043655,0,0,NA,NA,none,hothiphop.parents,hot.parents
2019,1,WCR2019_1138,2,WCR2019_0421,WCR2019_0327,within-group subordinate,within-group subordinate,176,149,27,9,21,158,170,1,99999,8345,8210,8195,0.124387035043655,0,0,NA,NA,none,hothiphop.parents,hot.parents
2019,1,WCR2019_1138,3,WCR2019_0421,WCR2019_0122,within-group subordinate,within-group subordinate,180,152,28,9,21,161,173,1,99999,8345,8295,8279,0.124387035043655,0,0,NA,NA,none,hothiphop.parents,hot.parents
2019,1,WCR2019_1140,1,WCR2019_0585,WCR2019_0122,within-group subordinate,within-group subordinate,265,218,47,5,44,223,262,1,99999,8344,8303,8278,0.094395985183415,0,0,NA,NA,none,hothiphop.parents,hot.parents
2019,1,WCR2019_1140,2,WCR2019_0585,WCR2019_0327,within-group subordinate,within-group subordinate,268,231,37,5,35,236,266,1,99999,8344,8219,8195,0.094395985183415,0,0,NA,NA,none,hothiphop.parents,hot.parents
2019,1,WCR2019_1140,3,WCR2019_0585,WCR2019_0161,within-group subordinate,within-group subordinate,279,226,53,5,52,231,278,1,99999,8344,8235,8210,0.094395985183415,0,0,NA,NA,none,hothiphop.parents,hot.parents
2019,1,WCR2019_1142,1,WCR2019_0223,WCR2019_0641,within-group subordinate,within-group subordinate,371,298,73,48,77,346,375,1,99999,6065,6164,4553,0.0971524288107203,0,0,NA,NA,none,hothiphop.parents,hot.parents
2019,1,WCR2019_1142,2,WCR2019_0126,WCR2019_0641,within-group subordinate,within-group subordinate,395,276,119,127,77,403,353,1,99999,5302,6164,3953,0.0971524288107203,0,0,NA,NA,none,hothiphop.parents,hot.parents
2019,1,WCR2019_1142,3,WCR2019_0223,WCR2019_0087,within-group subordinate,within-group subordinate,414,351,63,48,50,399,401,1,99999,6065,7297,5270,0.0971524288107203,0,0,NA,NA,none,hothiphop.parents,hot.parents
2019,1,WCR2019_1144,1,WCR2019_0008,WCR2019_0047,within-group subordinate,within-group subordinate,245,208,37,33,5,241,213,1,99999,8200,8326,8189,0.126184478829315,0,0,NA,NA,none,hothiphop.parents,hot.parents
2019,1,WCR2019_1144,2,WCR2019_0361,WCR2019_0047,within-group subordinate,within-group subordinate,250,210,40,37,5,247,215,1,99999,7949,8326,7940,0.126184478829315,0,0,NA,NA,none,hothiphop.parents,hot.parents
2019,1,WCR2019_1144,3,WCR2019_0166,WCR2019_0047,within-group subordinate,within-group subordinate,252,222,30,26,5,248,227,1,99999,8327,8326,8316,0.126184478829315,0,0,NA,NA,none,hothiphop.parents,hot.parents
2019,1,WCR2019_1145,1,WCR2019_0223,WCR2019_0285,within-group subordinate,within-group subordinate,258,217,41,36,7,253,224,1,99999,6066,8325,6047,0.145384983261597,0,0,NA,NA,none,hothiphop.parents,hot.parents
2019,1,WCR2019_1145,2,WCR2019_0223,WCR2019_0641,within-group subordinate,within-group subordinate,282,231,51,36,50,267,281,1,99999,6066,6169,4553,0.145384983261597,0,0,NA,NA,none,hothiphop.parents,hot.parents
2019,1,WCR2019_1145,3,WCR2019_0008,WCR2019_0285,within-group subordinate,within-group subordinate,314,285,29,23,7,308,292,1,99999,8227,8325,8189,0.145384983261597,0,0,NA,NA,none,hothiphop.parents,hot.parents
2019,1,WCR2019_1146,1,WCR2019_0524,WCR2019_0451,within-group subordinate,within-group subordinate,10,3,7,2,5,5,8,1,99999,8286,8309,8254,0.147584222515286,0,0,NA,NA,none,hothiphop.parents,hot.parents
2019,1,WCR2019_1146,2,WCR2019_0524,WCR2019_0327,within-group subordinate,within-group subordinate,187,174,13,2,11,176,185,1,99999,8286,8191,8139,0.147584222515286,0,0,NA,NA,none,hothiphop.parents,hot.parents
2019,1,WCR2019_1146,3,WCR2019_0524,WCR2019_0257,within-group subordinate,within-group subordinate,191,173,18,2,16,175,189,1,99999,8286,8303,8249,0.147584222515286,0,0,NA,NA,none,hothiphop.parents,hot.parents
2019,1,WCR2019_1147,1,WCR2019_0223,WCR2019_0641,within-group subordinate,within-group subordinate,275,229,46,36,45,265,274,1,99999,6033,6137,4531,0.138544798556825,0,0,NA,NA,none,hothiphop.parents,hot.parents
2019,1,WCR2019_1147,2,WCR2019_0223,WCR2019_0327,within-group subordinate,within-group subordinate,298,259,39,36,13,295,272,1,99999,6033,8166,5947,0.138544798556825,0,0,NA,NA,none,hothiphop.parents,hot.parents
2019,1,WCR2019_1147,3,WCR2019_0223,WCR2019_0075,within-group subordinate,within-group subordinate,310,267,43,36,34,303,301,1,99999,6033,7774,5604,0.138544798556825,0,0,NA,NA,none,hothiphop.parents,hot.parents
2019,1,WCR2019_1148,1,WCR2019_0223,WCR2019_0641,within-group subordinate,within-group subordinate,366,294,72,49,81,343,375,1,99999,6064,6166,4553,0.122397702799713,0,0,NA,NA,none,hothiphop.parents,hot.parents
2019,1,WCR2019_1148,2,WCR2019_0208,WCR2019_0327,within-group subordinate,within-group subordinate,382,311,71,53,30,364,341,1,99999,8269,8207,8122,0.122397702799713,0,0,NA,NA,none,hothiphop.parents,hot.parents
2019,1,WCR2019_1148,3,WCR2019_0208,WCR2019_0641,within-group subordinate,within-group subordinate,382,287,95,53,81,340,368,1,99999,8269,6166,6106,0.122397702799713,0,0,NA,NA,none,hothiphop.parents,hot.parents
2019,1,WCR2019_1149,1,WCR2019_0373,WCR2019_0641,within-group subordinate,within-group subordinate,266,208,58,16,53,224,261,1,99999,7887,5963,5836,0.121591472483887,0,0,NA,NA,none,hothiphop.parents,hot.parents
2019,1,WCR2019_1149,2,WCR2019_0373,WCR2019_0327,within-group subordinate,within-group subordinate,275,247,28,16,14,263,261,1,99999,7887,7931,7756,0.121591472483887,0,0,NA,NA,none,hothiphop.parents,hot.parents
2019,1,WCR2019_1149,3,WCR2019_0223,WCR2019_0641,within-group subordinate,within-group subordinate,280,224,56,38,53,262,277,1,99999,5871,5963,4416,0.121591472483887,0,0,NA,NA,none,hothiphop.parents,hot.parents
2019,1,WCR2019_1150,1,WCR2019_0223,WCR2019_0641,within-group subordinate,within-group subordinate,292,240,52,39,48,279,288,1,99999,6056,6150,4547,0.132389974817124,0,0,NA,NA,none,hothiphop.parents,hot.parents
2019,1,WCR2019_1150,2,WCR2019_0440,WCR2019_0641,within-group subordinate,within-group subordinate,335,279,56,44,48,323,327,1,99999,6930,6150,5153,0.132389974817124,0,0,NA,NA,none,hothiphop.parents,hot.parents
2019,1,WCR2019_1150,3,WCR2019_0126,WCR2019_0641,within-group subordinate,within-group subordinate,344,227,117,133,48,360,275,1,99999,5283,6150,3939,0.132389974817124,0,0,NA,NA,none,hothiphop.parents,hot.parents
2019,1,WCR2019_1151,1,WCR2019_0223,WCR2019_0359,within-group subordinate,within-group subordinate,210,165,45,47,2,212,167,1,99999,5955,8066,5886,0.115662061376696,0,0,NA,NA,none,hothiphop.parents,hot.parents
2019,1,WCR2019_1151,2,WCR2019_0223,WCR2019_0641,within-group subordinate,within-group subordinate,234,178,56,47,44,225,222,1,99999,5955,6050,4480,0.115662061376696,0,0,NA,NA,none,hothiphop.parents,hot.parents
2019,1,WCR2019_1151,3,WCR2019_0008,WCR2019_0359,within-group subordinate,within-group subordinate,238,220,18,18,2,238,222,1,99999,8046,8066,7936,0.115662061376696,0,0,NA,NA,none,hothiphop.parents,hot.parents
2019,1,WCR2019_1153,1,WCR2019_0008,WCR2019_0150,within-group subordinate,within-group subordinate,246,218,28,23,5,241,223,1,99999,8003,8113,7981,0.11295476892822,0,0,NA,NA,none,hothiphop.parents,hot.parents
2019,1,WCR2019_1153,2,WCR2019_0011,WCR2019_0150,within-group subordinate,within-group subordinate,253,216,37,32,5,248,221,1,99999,8122,8113,8099,0.11295476892822,0,0,NA,NA,none,hothiphop.parents,hot.parents
2019,1,WCR2019_1153,3,WCR2019_0499,WCR2019_0150,within-group subordinate,within-group subordinate,264,218,46,41,5,259,223,1,99999,8097,8113,8075,0.11295476892822,0,0,NA,NA,none,hothiphop.parents,hot.parents
2019,1,WCR2019_1154,1,WCR2019_0223,WCR2019_0641,within-group subordinate,within-group subordinate,260,206,54,24,65,230,271,1,99999,5993,6083,4504,0.122300412521233,0,0,NA,NA,none,hothiphop.parents,hot.parents
2019,1,WCR2019_1154,2,WCR2019_0223,WCR2019_0075,within-group subordinate,within-group subordinate,291,258,33,24,31,282,289,1,99999,5993,7697,5561,0.122300412521233,0,0,NA,NA,none,hothiphop.parents,hot.parents
2019,1,WCR2019_1154,3,WCR2019_0223,WCR2019_0327,within-group subordinate,within-group subordinate,302,273,29,24,17,297,290,1,99999,5993,8098,5912,0.122300412521233,0,0,NA,NA,none,hothiphop.parents,hot.parents
2019,1,WCR2019_1155,1,WCR2019_0223,WCR2019_0641,within-group subordinate,within-group subordinate,303,246,57,36,68,282,314,1,99999,5961,6026,4474,0.103891336270191,0,0,NA,NA,none,hothiphop.parents,hot.parents
2019,1,WCR2019_1155,2,WCR2019_0223,WCR2019_0204,within-group subordinate,within-group subordinate,319,269,50,36,30,305,299,1,99999,5961,8157,5954,0.103891336270191,0,0,NA,NA,none,hothiphop.parents,hot.parents
2019,1,WCR2019_1155,3,WCR2019_0223,WCR2019_0161,within-group subordinate,within-group subordinate,321,279,42,36,28,315,307,1,99999,5961,8038,5866,0.103891336270191,0,0,NA,NA,none,hothiphop.parents,hot.parents
2019,1,WCR2019_1156,1,WCR2019_0360,WCR2019_0641,within-group subordinate,within-group subordinate,264,214,50,0,52,214,266,1,99999,8131,6132,6020,0.138018322082932,0,0,NA,NA,none,hothiphop.parents,hot.parents
2019,1,WCR2019_1156,2,WCR2019_0360,WCR2019_0327,within-group subordinate,within-group subordinate,274,259,15,0,15,259,274,1,99999,8131,8145,7982,0.138018322082932,0,0,NA,NA,none,hothiphop.parents,hot.parents
2019,1,WCR2019_1156,3,WCR2019_0360,WCR2019_0161,within-group subordinate,within-group subordinate,278,263,15,0,15,263,278,1,99999,8131,8165,8009,0.138018322082932,0,0,NA,NA,none,hothiphop.parents,hot.parents
2019,1,WCR2019_1158,1,WCR2019_0223,WCR2019_0641,within-group subordinate,within-group subordinate,192,161,31,27,10,188,171,1,99999,5909,5993,4440,0.168514412416851,0,0,NA,NA,none,hothiphop.parents,hot.parents
2019,1,WCR2019_1158,2,WCR2019_0223,WCR2019_0088,within-group subordinate,within-group subordinate,201,179,22,27,5,206,184,1,99999,5909,7170,5203,0.168514412416851,0,0,NA,NA,none,hothiphop.parents,hot.parents
2019,1,WCR2019_1158,3,WCR2019_0223,WCR2019_0075,within-group subordinate,within-group subordinate,209,181,28,27,4,208,185,1,99999,5909,7585,5485,0.168514412416851,0,0,NA,NA,none,hothiphop.parents,hot.parents
2019,1,WCR2019_1159,1,WCR2019_0420,WCR2019_0325,within-group subordinate,within-group subordinate,11,9,2,2,0,11,9,1,99999,8096,8071,8060,0.0574599260172626,0,0,NA,NA,none,hothiphop.parents,hot.parents
2019,1,WCR2019_1159,2,WCR2019_0420,WCR2019_0592,within-group subordinate,within-group subordinate,42,31,11,2,9,33,40,1,99999,8096,8079,8067,0.0574599260172626,0,0,NA,NA,none,hothiphop.parents,hot.parents
2019,1,WCR2019_1159,3,WCR2019_0474,WCR2019_0325,within-group subordinate,within-group subordinate,46,39,7,8,0,47,39,1,99999,7800,8071,7763,0.0574599260172626,0,0,NA,NA,none,hothiphop.parents,hot.parents
2019,1,WCR2019_1160,1,WCR2019_0223,WCR2019_0641,within-group subordinate,within-group subordinate,192,172,20,17,13,189,185,1,99999,5937,6017,4460,0.170854271356784,0,0,NA,NA,none,hothiphop.parents,hot.parents
2019,1,WCR2019_1160,2,WCR2019_0151,WCR2019_0078,within-group subordinate,within-group subordinate,231,156,75,71,5,227,161,1,99999,8138,8119,8098,0.170854271356784,0,0,NA,NA,none,hothiphop.parents,hot.parents
2019,1,WCR2019_1160,3,WCR2019_0223,WCR2019_0088,within-group subordinate,within-group subordinate,234,218,16,17,3,235,221,1,99999,5937,7200,5223,0.170854271356784,0,0,NA,NA,none,hothiphop.parents,hot.parents
2019,1,WCR2019_1161,1,WCR2019_0223,WCR2019_0641,within-group subordinate,within-group subordinate,225,167,58,33,62,200,229,1,99999,5385,5427,4052,0.100681198910082,0,0,NA,NA,none,hothiphop.parents,hot.parents
2019,1,WCR2019_1161,2,WCR2019_0223,WCR2019_0206,within-group subordinate,within-group subordinate,235,187,48,33,32,220,219,1,99999,5385,7284,5348,0.100681198910082,0,0,NA,NA,none,hothiphop.parents,hot.parents
2019,1,WCR2019_1161,3,WCR2019_0223,WCR2019_0327,within-group subordinate,within-group subordinate,243,203,40,33,30,236,233,1,99999,5385,7223,5318,0.100681198910082,0,0,NA,NA,none,hothiphop.parents,hot.parents
2019,1,WCR2019_1162,1,WCR2019_0141,WCR2019_0519,within-group subordinate,within-group subordinate,201,175,26,16,13,191,188,1,99999,7963,7930,7917,0.106681709916009,0,0,NA,NA,none,hothiphop.parents,hot.parents
2019,1,WCR2019_1162,2,WCR2019_0008,WCR2019_0519,within-group subordinate,within-group subordinate,208,176,32,22,13,198,189,1,99999,7844,7930,7800,0.106681709916009,0,0,NA,NA,none,hothiphop.parents,hot.parents
2019,1,WCR2019_1162,3,WCR2019_0441,WCR2019_0519,within-group subordinate,within-group subordinate,209,187,22,11,13,198,200,1,99999,7954,7930,7908,0.106681709916009,0,0,NA,NA,none,hothiphop.parents,hot.parents
2019,1,WCR2019_1163,1,WCR2019_0256,WCR2019_0088,within-group subordinate,within-group subordinate,73,59,14,10,10,69,69,1,99999,7360,6588,6531,0.0296456003234065,0,0,NA,NA,none,hothiphop.parents,hot.parents
2019,1,WCR2019_1163,2,WCR2019_0499,WCR2019_0088,within-group subordinate,within-group subordinate,75,64,11,7,10,71,74,1,99999,7383,6588,6554,0.0296456003234065,0,0,NA,NA,none,hothiphop.parents,hot.parents
2019,1,WCR2019_1163,3,WCR2019_0441,WCR2019_0088,within-group subordinate,within-group subordinate,77,65,12,7,10,72,75,1,99999,7402,6588,6571,0.0296456003234065,0,0,NA,NA,none,hothiphop.parents,hot.parents
2019,1,WCR2019_1164,1,WCR2019_0361,WCR2019_0405,within-group subordinate,within-group subordinate,35,28,7,7,0,35,28,1,99999,6800,7033,6721,0.0233211576285473,0,0,NA,NA,none,hothiphop.parents,hot.parents
2019,1,WCR2019_1164,2,WCR2019_0396,WCR2019_0405,within-group subordinate,within-group subordinate,36,29,7,7,0,36,29,1,99999,7101,7033,7016,0.0233211576285473,0,0,NA,NA,none,hothiphop.parents,hot.parents
2019,1,WCR2019_1164,3,WCR2019_0260,WCR2019_0405,within-group subordinate,within-group subordinate,40,35,5,6,0,41,35,1,99999,7046,7033,6963,0.0233211576285473,0,0,NA,NA,none,hothiphop.parents,hot.parents
2019,1,WCR2019_1166,1,WCR2019_0223,WCR2019_0641,within-group subordinate,within-group subordinate,220,191,29,29,25,220,216,1,99999,5861,5928,4403,0.136912918898717,0,0,NA,NA,none,hothiphop.parents,hot.parents
2019,1,WCR2019_1166,2,WCR2019_0008,WCR2019_0641,within-group subordinate,within-group subordinate,257,229,28,9,25,238,254,1,99999,7895,5928,5842,0.136912918898717,0,0,NA,NA,none,hothiphop.parents,hot.parents
2019,1,WCR2019_1166,3,WCR2019_0089,WCR2019_0641,within-group subordinate,within-group subordinate,262,209,53,46,25,255,234,1,99999,7977,5928,5886,0.136912918898717,0,0,NA,NA,none,hothiphop.parents,hot.parents
2019,1,WCR2019_1167,1,WCR2019_0223,WCR2019_0641,within-group subordinate,within-group subordinate,316,251,65,37,78,288,329,1,99999,5936,6038,4453,0.0974477958236659,0,0,NA,NA,none,hothiphop.parents,hot.parents
2019,1,WCR2019_1167,2,WCR2019_0223,WCR2019_0122,within-group subordinate,within-group subordinate,345,303,42,37,25,340,328,1,99999,5936,8124,5887,0.0974477958236659,0,0,NA,NA,none,hothiphop.parents,hot.parents
2019,1,WCR2019_1167,3,WCR2019_0440,WCR2019_0641,within-group subordinate,within-group subordinate,352,277,75,35,78,312,355,1,99999,6805,6038,5055,0.0974477958236659,0,0,NA,NA,none,hothiphop.parents,hot.parents
2019,1,WCR2019_1168,1,WCR2019_0223,WCR2019_0641,within-group subordinate,within-group subordinate,191,169,22,19,9,188,178,1,99999,5810,5899,4371,0.170212765957447,0,0,NA,NA,none,hothiphop.parents,hot.parents
2019,1,WCR2019_1168,2,WCR2019_0223,WCR2019_0075,within-group subordinate,within-group subordinate,203,183,20,19,3,202,186,1,99999,5810,7488,5413,0.170212765957447,0,0,NA,NA,none,hothiphop.parents,hot.parents
2019,1,WCR2019_1168,3,WCR2019_0223,WCR2019_0088,within-group subordinate,within-group subordinate,211,197,14,19,3,216,200,1,99999,5810,7089,5143,0.170212765957447,0,0,NA,NA,none,hothiphop.parents,hot.parents
2019,1,WCR2019_1169,1,WCR2019_0223,WCR2019_0641,within-group subordinate,within-group subordinate,297,229,68,42,72,271,301,1,99999,6069,6169,4558,0.120172187014229,0,0,NA,NA,none,hothiphop.parents,hot.parents
2019,1,WCR2019_1169,2,WCR2019_0223,WCR2019_0161,within-group subordinate,within-group subordinate,321,273,48,42,23,315,296,1,99999,6069,8230,5975,0.120172187014229,0,0,NA,NA,none,hothiphop.parents,hot.parents
2019,1,WCR2019_1169,3,WCR2019_0223,WCR2019_0327,within-group subordinate,within-group subordinate,335,285,50,42,31,327,316,1,99999,6069,8212,5983,0.120172187014229,0,0,NA,NA,none,hothiphop.parents,hot.parents
2019,1,WCR2019_1171,1,WCR2019_0420,WCR2019_0325,within-group subordinate,within-group subordinate,15,10,5,4,1,14,11,1,99999,8178,8152,8136,0.0519638936325933,0,0,NA,NA,none,hothiphop.parents,hot.parents
2019,1,WCR2019_1171,2,WCR2019_0420,WCR2019_0592,within-group subordinate,within-group subordinate,46,30,16,4,12,34,42,1,99999,8178,8165,8147,0.0519638936325933,0,0,NA,NA,none,hothiphop.parents,hot.parents
2019,1,WCR2019_1171,3,WCR2019_0474,WCR2019_0325,within-group subordinate,within-group subordinate,53,43,10,9,1,52,44,1,99999,7872,8152,7830,0.0519638936325933,0,0,NA,NA,none,hothiphop.parents,hot.parents
2019,1,WCR2019_1172,1,WCR2019_0223,WCR2019_0641,within-group subordinate,within-group subordinate,332,244,88,59,86,303,330,1,99999,6069,6167,4557,0.101435406698565,0,0,NA,NA,none,hothiphop.parents,hot.parents
2019,1,WCR2019_1172,2,WCR2019_0223,WCR2019_0327,within-group subordinate,within-group subordinate,361,299,62,59,30,358,329,1,99999,6069,8209,5983,0.101435406698565,0,0,NA,NA,none,hothiphop.parents,hot.parents
2019,1,WCR2019_1172,3,WCR2019_0126,WCR2019_0641,within-group subordinate,within-group subordinate,369,244,125,128,86,372,330,1,99999,5304,6167,3958,0.101435406698565,0,0,NA,NA,none,hothiphop.parents,hot.parents
2019,1,WCR2019_1173,1,WCR2019_0223,WCR2019_0322,within-group subordinate,within-group subordinate,219,186,33,30,3,216,189,1,99999,5952,8143,5930,0.102959158718513,0,0,NA,NA,none,hothiphop.parents,hot.parents
2019,1,WCR2019_1173,2,WCR2019_0440,WCR2019_0322,within-group subordinate,within-group subordinate,245,213,32,29,3,242,216,1,99999,6810,8143,6782,0.102959158718513,0,0,NA,NA,none,hothiphop.parents,hot.parents
2019,1,WCR2019_1173,3,WCR2019_0076,WCR2019_0322,within-group subordinate,within-group subordinate,265,238,27,25,3,263,241,1,99999,7045,8143,7012,0.102959158718513,0,0,NA,NA,none,hothiphop.parents,hot.parents
2019,1,WCR2019_1174,1,WCR2019_0474,WCR2019_0405,within-group subordinate,within-group subordinate,62,51,11,12,0,63,51,1,99999,7800,7963,7662,0.0268638324091189,0,0,NA,NA,none,hothiphop.parents,hot.parents
2019,1,WCR2019_1174,2,WCR2019_0338,WCR2019_0405,within-group subordinate,within-group subordinate,65,55,10,10,0,65,55,1,99999,8096,7963,7945,0.0268638324091189,0,0,NA,NA,none,hothiphop.parents,hot.parents
2019,1,WCR2019_1174,3,WCR2019_0252,WCR2019_0405,within-group subordinate,within-group subordinate,68,56,12,12,0,68,56,1,99999,8067,7963,7916,0.0268638324091189,0,0,NA,NA,none,hothiphop.parents,hot.parents
2019,1,WCR2019_1175,1,WCR2019_0223,WCR2019_0516,within-group subordinate,within-group subordinate,219,166,53,50,4,216,170,1,99999,5975,8171,5947,0.0916169850346757,0,0,NA,NA,none,hothiphop.parents,hot.parents
2019,1,WCR2019_1175,2,WCR2019_0397,WCR2019_0516,within-group subordinate,within-group subordinate,244,190,54,50,4,240,194,1,99999,8172,8171,8124,0.0916169850346757,0,0,NA,NA,none,hothiphop.parents,hot.parents
2019,1,WCR2019_1175,3,WCR2019_0556,WCR2019_0516,within-group subordinate,within-group subordinate,250,203,47,43,4,246,207,1,99999,8153,8171,8108,0.0916169850346757,0,0,NA,NA,none,hothiphop.parents,hot.parents
2019,1,WCR2019_1326,1,WCR2019_0223,WCR2019_0641,within-group subordinate,within-group subordinate,216,172,44,21,50,193,222,1,99999,5072,5169,3823,0.0903493699885452,0,0,NA,NA,none,hothiphop.parents,hot.parents
2019,1,WCR2019_1326,2,WCR2019_0223,WCR2019_0327,within-group subordinate,within-group subordinate,223,200,23,21,9,221,209,1,99999,5072,6852,4999,0.0903493699885452,0,0,NA,NA,none,hothiphop.parents,hot.parents
2019,1,WCR2019_1326,3,WCR2019_0223,WCR2019_0087,within-group subordinate,within-group subordinate,238,208,30,21,23,229,231,1,99999,5072,6219,4495,0.0903493699885452,0,0,NA,NA,none,hothiphop.parents,hot.parents
2019,1,WCR2019_1327,1,WCR2019_0223,WCR2019_0257,within-group subordinate,within-group subordinate,179,163,16,15,1,178,164,1,99999,5242,7088,5224,0.138182839488836,0,0,NA,NA,none,hothiphop.parents,hot.parents
2019,1,WCR2019_1327,2,WCR2019_0440,WCR2019_0257,within-group subordinate,within-group subordinate,204,187,17,17,1,204,188,1,99999,5962,7088,5940,0.138182839488836,0,0,NA,NA,none,hothiphop.parents,hot.parents
2019,1,WCR2019_1327,3,WCR2019_0076,WCR2019_0257,within-group subordinate,within-group subordinate,205,189,16,15,1,204,190,1,99999,6230,7088,6198,0.138182839488836,0,0,NA,NA,none,hothiphop.parents,hot.parents
2019,1,WCR2019_1328,1,WCR2019_0223,WCR2019_0641,within-group subordinate,within-group subordinate,248,207,41,35,37,242,244,1,99999,5769,5858,4340,0.104618879353862,0,0,NA,NA,none,hothiphop.parents,hot.parents
2019,1,WCR2019_1328,2,WCR2019_0215,WCR2019_0641,within-group subordinate,within-group subordinate,266,220,46,21,37,241,257,1,99999,7868,5858,5823,0.104618879353862,0,0,NA,NA,none,hothiphop.parents,hot.parents
2019,1,WCR2019_1328,3,WCR2019_0440,WCR2019_0079,within-group subordinate,within-group subordinate,272,230,42,26,27,256,257,1,99999,6600,7897,6577,0.104618879353862,0,0,NA,NA,none,hothiphop.parents,hot.parents
2019,1,WCR2019_1329,1,WCR2019_0223,WCR2019_0641,within-group subordinate,within-group subordinate,275,207,68,48,71,255,278,1,99999,5721,5778,4296,0.0978107796696966,0,0,NA,NA,none,hothiphop.parents,hot.parents
2019,1,WCR2019_1329,2,WCR2019_0223,WCR2019_0327,within-group subordinate,within-group subordinate,308,256,52,48,17,304,273,1,99999,5721,7678,5646,0.0978107796696966,0,0,NA,NA,none,hothiphop.parents,hot.parents
2019,1,WCR2019_1329,3,WCR2019_0223,WCR2019_0161,within-group subordinate,within-group subordinate,309,258,51,48,24,306,282,1,99999,5721,7680,5626,0.0978107796696966,0,0,NA,NA,none,hothiphop.parents,hot.parents
2019,1,WCR2019_1330,1,WCR2019_0282,WCR2019_0327,within-group subordinate,within-group subordinate,182,158,24,17,10,175,168,1,99999,7163,7110,7037,0.11975138121547,0,0,NA,NA,none,hothiphop.parents,hot.parents
2019,1,WCR2019_1330,2,WCR2019_0282,WCR2019_0641,within-group subordinate,within-group subordinate,183,148,35,17,28,165,176,1,99999,7163,5725,5661,0.11975138121547,0,0,NA,NA,none,hothiphop.parents,hot.parents
2019,1,WCR2019_1330,3,WCR2019_0282,WCR2019_0122,within-group subordinate,within-group subordinate,186,163,23,17,9,180,172,1,99999,7163,7182,7107,0.11975138121547,0,0,NA,NA,none,hothiphop.parents,hot.parents
2019,1,WCR2019_1331,1,WCR2019_0223,WCR2019_0641,within-group subordinate,within-group subordinate,316,238,78,46,85,284,323,1,99999,5909,6023,4455,0.0956126336487649,0,0,NA,NA,none,hothiphop.parents,hot.parents
2019,1,WCR2019_1331,2,WCR2019_0223,WCR2019_0087,within-group subordinate,within-group subordinate,319,261,58,46,46,307,307,1,99999,5909,7085,5122,0.0956126336487649,0,0,NA,NA,none,hothiphop.parents,hot.parents
2019,1,WCR2019_1331,3,WCR2019_0223,WCR2019_0327,within-group subordinate,within-group subordinate,341,289,52,46,24,335,313,1,99999,5909,7993,5828,0.0956126336487649,0,0,NA,NA,none,hothiphop.parents,hot.parents
2019,1,WCR2019_1332,1,WCR2019_0223,WCR2019_0641,within-group subordinate,within-group subordinate,186,171,15,21,13,192,184,1,99999,5808,5873,4358,0.161107614852108,0,0,NA,NA,none,hothiphop.parents,hot.parents
2019,1,WCR2019_1332,2,WCR2019_0223,WCR2019_0327,within-group subordinate,within-group subordinate,225,201,24,21,3,222,204,1,99999,5808,7805,5726,0.161107614852108,0,0,NA,NA,none,hothiphop.parents,hot.parents
2019,1,WCR2019_1332,3,WCR2019_0223,WCR2019_0122,within-group subordinate,within-group subordinate,226,204,22,21,3,225,207,1,99999,5808,7883,5762,0.161107614852108,0,0,NA,NA,none,hothiphop.parents,hot.parents
2019,1,WCR2019_1333,1,WCR2019_0223,WCR2019_0641,within-group subordinate,within-group subordinate,256,197,59,45,56,242,253,1,99999,5916,6010,4449,0.13693405511811,0,0,NA,NA,none,hothiphop.parents,hot.parents
2019,1,WCR2019_1333,2,WCR2019_0223,WCR2019_0122,within-group subordinate,within-group subordinate,296,248,48,45,10,293,258,1,99999,5916,8063,5866,0.13693405511811,0,0,NA,NA,none,hothiphop.parents,hot.parents
2019,1,WCR2019_1333,3,WCR2019_0223,WCR2019_0327,within-group subordinate,within-group subordinate,298,251,47,45,11,296,262,1,99999,5916,7981,5833,0.13693405511811,0,0,NA,NA,none,hothiphop.parents,hot.parents
2019,1,WCR2019_1335,1,WCR2019_0223,WCR2019_0258,within-group subordinate,within-group subordinate,245,190,55,57,5,247,195,1,99999,6063,8278,6020,0.141318655019744,0,0,NA,NA,none,hothiphop.parents,hot.parents
2019,1,WCR2019_1335,2,WCR2019_0008,WCR2019_0258,within-group subordinate,within-group subordinate,274,256,18,16,5,272,261,1,99999,8220,8278,8142,0.141318655019744,0,0,NA,NA,none,hothiphop.parents,hot.parents
2019,1,WCR2019_1335,3,WCR2019_0223,WCR2019_0641,within-group subordinate,within-group subordinate,282,214,68,57,50,271,264,1,99999,6063,6164,4552,0.141318655019744,0,0,NA,NA,none,hothiphop.parents,hot.parents
2019,1,WCR2019_1336,1,WCR2019_0223,WCR2019_0285,within-group subordinate,within-group subordinate,257,211,46,41,8,252,219,1,99999,6071,8324,6052,0.132368767188808,0,0,NA,NA,none,hothiphop.parents,hot.parents
2019,1,WCR2019_1336,2,WCR2019_0219,WCR2019_0285,within-group subordinate,within-group subordinate,269,205,64,58,8,263,213,1,99999,7583,8324,7553,0.132368767188808,0,0,NA,NA,none,hothiphop.parents,hot.parents
2019,1,WCR2019_1336,3,WCR2019_0223,WCR2019_0641,within-group subordinate,within-group subordinate,275,223,52,41,44,264,267,1,99999,6071,6171,4560,0.132368767188808,0,0,NA,NA,none,hothiphop.parents,hot.parents
2019,1,WCR2019_1338,1,WCR2019_0223,WCR2019_0641,within-group subordinate,within-group subordinate,261,195,66,44,63,239,258,1,99999,5932,6026,4459,0.108687660825879,0,0,NA,NA,none,hothiphop.parents,hot.parents
2019,1,WCR2019_1338,2,WCR2019_0223,WCR2019_0327,within-group subordinate,within-group subordinate,289,237,52,44,25,281,262,1,99999,5932,8018,5850,0.108687660825879,0,0,NA,NA,none,hothiphop.parents,hot.parents
2019,1,WCR2019_1338,3,WCR2019_0223,WCR2019_0122,within-group subordinate,within-group subordinate,291,240,51,44,31,284,271,1,99999,5932,8096,5883,0.108687660825879,0,0,NA,NA,none,hothiphop.parents,hot.parents
2019,1,WCR2019_1339,1,WCR2019_0420,WCR2019_0325,within-group subordinate,within-group subordinate,7,5,2,1,1,6,6,1,99999,8193,8164,8152,0.0453216374269006,0,0,NA,NA,none,hothiphop.parents,hot.parents
2019,1,WCR2019_1339,2,WCR2019_0420,WCR2019_0592,within-group subordinate,within-group subordinate,50,39,11,1,10,40,49,1,99999,8193,8177,8164,0.0453216374269006,0,0,NA,NA,none,hothiphop.parents,hot.parents
2019,1,WCR2019_1339,3,WCR2019_0474,WCR2019_0325,within-group subordinate,within-group subordinate,57,48,9,8,1,56,49,1,99999,7887,8164,7847,0.0453216374269006,0,0,NA,NA,none,hothiphop.parents,hot.parents
2019,1,WCR2019_1340,1,WCR2019_0536,WCR2019_0463,within-group subordinate,within-group subordinate,16,8,8,4,4,12,12,1,99999,8193,8265,8178,0.120169082125604,0,0,NA,NA,none,hothiphop.parents,hot.parents
2019,1,WCR2019_1340,2,WCR2019_0536,WCR2019_0122,within-group subordinate,within-group subordinate,215,190,25,4,21,194,211,1,99999,8193,8215,8129,0.120169082125604,0,0,NA,NA,none,hothiphop.parents,hot.parents
2019,1,WCR2019_1340,3,WCR2019_0536,WCR2019_0039,within-group subordinate,within-group subordinate,218,176,42,4,38,180,214,1,99999,8193,8156,8071,0.120169082125604,0,0,NA,NA,none,hothiphop.parents,hot.parents
2019,1,WCR2019_1341,1,WCR2019_0223,WCR2019_0641,within-group subordinate,within-group subordinate,274,219,55,31,66,250,285,1,99999,6001,6104,4509,0.121069182389937,0,0,NA,NA,none,hothiphop.parents,hot.parents
2019,1,WCR2019_1341,2,WCR2019_0223,WCR2019_0327,within-group subordinate,within-group subordinate,303,266,37,31,17,297,283,1,99999,6001,8120,5917,0.121069182389937,0,0,NA,NA,none,hothiphop.parents,hot.parents
2019,1,WCR2019_1341,3,WCR2019_0223,WCR2019_0122,within-group subordinate,within-group subordinate,318,272,46,31,40,303,312,1,99999,6001,8203,5952,0.121069182389937,0,0,NA,NA,none,hothiphop.parents,hot.parents
2019,1,WCR2019_1342,1,WCR2019_0223,WCR2019_0641,within-group subordinate,within-group subordinate,298,234,64,32,75,266,309,1,99999,5805,5886,4371,0.090726313144006,0,0,NA,NA,none,hothiphop.parents,hot.parents
2019,1,WCR2019_1342,2,WCR2019_0223,WCR2019_0087,within-group subordinate,within-group subordinate,321,274,47,32,36,306,310,1,99999,5805,6940,5035,0.090726313144006,0,0,NA,NA,none,hothiphop.parents,hot.parents
2019,1,WCR2019_1342,3,WCR2019_0126,WCR2019_0641,within-group subordinate,within-group subordinate,326,212,114,106,75,318,287,1,99999,5044,5886,3778,0.090726313144006,0,0,NA,NA,none,hothiphop.parents,hot.parents
2019,1,WCR2019_1343,1,WCR2019_0223,WCR2019_0516,within-group subordinate,within-group subordinate,193,164,29,27,2,191,166,1,99999,5339,7123,5314,0.0913152750628316,0,0,NA,NA,none,hothiphop.parents,hot.parents
2019,1,WCR2019_1343,2,WCR2019_0440,WCR2019_0516,within-group subordinate,within-group subordinate,199,172,27,26,2,198,174,1,99999,6044,7123,6013,0.0913152750628316,0,0,NA,NA,none,hothiphop.parents,hot.parents
2019,1,WCR2019_1343,3,WCR2019_0008,WCR2019_0516,within-group subordinate,within-group subordinate,206,189,17,17,2,206,191,1,99999,7049,7123,7010,0.0913152750628316,0,0,NA,NA,none,hothiphop.parents,hot.parents
2019,1,WCR2019_1344,1,WCR2019_0223,WCR2019_0641,within-group subordinate,within-group subordinate,266,212,54,38,51,250,263,1,99999,5588,5628,4221,0.0916271721958926,0,0,NA,NA,none,hothiphop.parents,hot.parents
2019,1,WCR2019_1344,2,WCR2019_0223,WCR2019_0327,within-group subordinate,within-group subordinate,275,232,43,38,16,270,248,1,99999,5588,7466,5516,0.0916271721958926,0,0,NA,NA,none,hothiphop.parents,hot.parents
2019,1,WCR2019_1344,3,WCR2019_0223,WCR2019_0075,within-group subordinate,within-group subordinate,282,225,57,38,44,263,269,1,99999,5588,7078,5181,0.0916271721958926,0,0,NA,NA,none,hothiphop.parents,hot.parents
2019,1,WCR2019_1345,1,WCR2019_0474,WCR2019_0516,within-group subordinate,within-group subordinate,72,58,14,8,6,66,64,1,99999,7907,8197,7859,0.164807179238419,0,0,NA,NA,none,hothiphop.parents,hot.parents
2019,1,WCR2019_1345,2,WCR2019_0345,WCR2019_0516,within-group subordinate,within-group subordinate,80,69,11,9,6,78,75,1,99999,8180,8197,8131,0.164807179238419,0,0,NA,NA,none,hothiphop.parents,hot.parents
2019,1,WCR2019_1345,3,WCR2019_0505,WCR2019_0516,within-group subordinate,within-group subordinate,84,56,28,22,6,78,62,1,99999,8187,8197,8139,0.164807179238419,0,0,NA,NA,none,hothiphop.parents,hot.parents
2019,1,WCR2019_1347,1,WCR2019_0223,WCR2019_0641,within-group subordinate,within-group subordinate,186,158,28,38,12,196,170,1,99999,6009,6087,4514,0.166990055784623,0,0,NA,NA,none,hothiphop.parents,hot.parents
2019,1,WCR2019_1347,2,WCR2019_0008,WCR2019_0641,within-group subordinate,within-group subordinate,214,200,14,5,12,205,212,1,99999,8116,6087,6002,0.166990055784623,0,0,NA,NA,none,hothiphop.parents,hot.parents
2019,1,WCR2019_1347,3,WCR2019_0223,WCR2019_0518,within-group subordinate,within-group subordinate,216,175,41,38,3,213,178,1,99999,6009,8216,5991,0.166990055784623,0,0,NA,NA,none,hothiphop.parents,hot.parents
2019,1,WCR2019_1348,1,WCR2019_0420,WCR2019_0325,within-group subordinate,within-group subordinate,10,7,3,2,1,9,8,1,99999,8281,8253,8239,0.0551940226560617,0,0,NA,NA,none,hothiphop.parents,hot.parents
2019,1,WCR2019_1348,2,WCR2019_0420,WCR2019_0592,within-group subordinate,within-group subordinate,27,20,7,2,5,22,25,1,99999,8281,8266,8251,0.0551940226560617,0,0,NA,NA,none,hothiphop.parents,hot.parents
2019,1,WCR2019_1348,3,WCR2019_0474,WCR2019_0325,within-group subordinate,within-group subordinate,60,50,10,10,1,60,51,1,99999,7966,8253,7924,0.0551940226560617,0,0,NA,NA,none,hothiphop.parents,hot.parents
2019,1,WCR2019_1350,1,WCR2019_0223,WCR2019_0641,within-group subordinate,within-group subordinate,271,210,61,47,46,257,256,1,99999,6019,6117,4514,0.126446480231437,0,0,NA,NA,none,hothiphop.parents,hot.parents
2019,1,WCR2019_1350,2,WCR2019_0440,WCR2019_0641,within-group subordinate,within-group subordinate,317,262,55,39,46,301,308,1,99999,6895,6117,5126,0.126446480231437,0,0,NA,NA,none,hothiphop.parents,hot.parents
2019,1,WCR2019_1350,3,WCR2019_0215,WCR2019_0641,within-group subordinate,within-group subordinate,319,248,71,47,46,295,294,1,99999,8238,6117,6080,0.126446480231437,0,0,NA,NA,none,hothiphop.parents,hot.parents
2019,1,WCR2019_1351,1,WCR2019_0474,WCR2019_0405,within-group subordinate,within-group subordinate,64,49,15,16,0,65,49,1,99999,7975,8145,7831,0.0255206452389551,0,0,NA,NA,none,hothiphop.parents,hot.parents
2019,1,WCR2019_1351,2,WCR2019_0260,WCR2019_0405,within-group subordinate,within-group subordinate,67,50,17,19,0,69,50,1,99999,8221,8145,8063,0.0255206452389551,0,0,NA,NA,none,hothiphop.parents,hot.parents
2019,1,WCR2019_1351,3,WCR2019_0256,WCR2019_0405,within-group subordinate,within-group subordinate,67,47,20,20,0,67,47,1,99999,8245,8145,8084,0.0255206452389551,0,0,NA,NA,none,hothiphop.parents,hot.parents
2019,1,WCR2019_1352,1,WCR2019_0223,WCR2019_0641,within-group subordinate,within-group subordinate,292,245,47,40,43,285,288,1,99999,6002,6099,4508,0.142027582869586,0,0,NA,NA,none,hothiphop.parents,hot.parents
2019,1,WCR2019_1352,2,WCR2019_0223,WCR2019_0122,within-group subordinate,within-group subordinate,333,291,42,40,15,331,306,1,99999,6002,8200,5952,0.142027582869586,0,0,NA,NA,none,hothiphop.parents,hot.parents
2019,1,WCR2019_1352,3,WCR2019_0223,WCR2019_0327,within-group subordinate,within-group subordinate,336,293,43,40,18,333,311,1,99999,6002,8117,5916,0.142027582869586,0,0,NA,NA,none,hothiphop.parents,hot.parents
2019,1,WCR2019_1353,1,WCR2019_0223,WCR2019_0641,within-group subordinate,within-group subordinate,212,194,18,21,8,215,202,1,99999,6047,6141,4537,0.174549819927971,0,0,NA,NA,none,hothiphop.parents,hot.parents
2019,1,WCR2019_1353,2,WCR2019_0008,WCR2019_0641,within-group subordinate,within-group subordinate,244,235,9,3,8,238,243,1,99999,8193,6141,6054,0.174549819927971,0,0,NA,NA,none,hothiphop.parents,hot.parents
2019,1,WCR2019_1353,3,WCR2019_0223,WCR2019_0206,within-group subordinate,within-group subordinate,248,226,22,21,4,247,230,1,99999,6047,8262,6001,0.174549819927971,0,0,NA,NA,none,hothiphop.parents,hot.parents
2019,1,WCR2019_1354,1,WCR2019_0482,WCR2019_0475,within-group subordinate,within-group subordinate,172,123,49,42,14,165,137,1,99999,8252,8328,8225,0.132256134051466,0,0,NA,NA,none,hothiphop.parents,hot.parents
2019,1,WCR2019_1354,2,WCR2019_0223,WCR2019_0475,within-group subordinate,within-group subordinate,236,186,50,45,14,231,200,1,99999,6064,8328,6052,0.132256134051466,0,0,NA,NA,none,hothiphop.parents,hot.parents
2019,1,WCR2019_1354,3,WCR2019_0440,WCR2019_0475,within-group subordinate,within-group subordinate,281,221,60,55,14,276,235,1,99999,6943,8328,6922,0.132256134051466,0,0,NA,NA,none,hothiphop.parents,hot.parents
2019,1,WCR2019_1356,1,WCR2019_0534,WCR2019_0066,within-group subordinate,within-group subordinate,110,81,29,26,3,107,84,1,99999,8342,8324,8296,0.131182795698925,0,0,NA,NA,none,hothiphop.parents,hot.parents
2019,1,WCR2019_1356,2,WCR2019_0008,WCR2019_0066,within-group subordinate,within-group subordinate,192,164,28,25,3,189,167,1,99999,8233,8324,8188,0.131182795698925,0,0,NA,NA,none,hothiphop.parents,hot.parents
2019,1,WCR2019_1356,3,WCR2019_0011,WCR2019_0066,within-group subordinate,within-group subordinate,199,156,43,40,3,196,159,1,99999,8356,8324,8310,0.131182795698925,0,0,NA,NA,none,hothiphop.parents,hot.parents
2019,1,WCR2019_1357,1,WCR2019_0223,WCR2019_0641,within-group subordinate,within-group subordinate,251,188,63,55,52,243,240,1,99999,5937,6014,4462,0.128038301006629,0,0,NA,NA,none,hothiphop.parents,hot.parents
2019,1,WCR2019_1357,2,WCR2019_0223,WCR2019_0061,within-group subordinate,within-group subordinate,289,221,68,55,37,276,258,1,99999,5937,7720,5608,0.128038301006629,0,0,NA,NA,none,hothiphop.parents,hot.parents
2019,1,WCR2019_1357,3,WCR2019_0223,WCR2019_0075,within-group subordinate,within-group subordinate,291,221,70,55,42,276,263,1,99999,5937,7614,5514,0.128038301006629,0,0,NA,NA,none,hothiphop.parents,hot.parents
2019,1,WCR2019_1358,1,WCR2019_0427,WCR2019_0047,within-group subordinate,within-group subordinate,155,133,22,6,16,139,149,1,99999,8254,8260,8243,0.133115705476968,0,0,NA,NA,none,hothiphop.parents,hot.parents
2019,1,WCR2019_1358,2,WCR2019_0427,WCR2019_0327,within-group subordinate,within-group subordinate,161,140,21,6,15,146,155,1,99999,8254,8123,8108,0.133115705476968,0,0,NA,NA,none,hothiphop.parents,hot.parents
2019,1,WCR2019_1358,3,WCR2019_0427,WCR2019_0206,within-group subordinate,within-group subordinate,161,134,27,6,21,140,155,1,99999,8254,8204,8188,0.133115705476968,0,0,NA,NA,none,hothiphop.parents,hot.parents
2019,1,WCR2019_1359,1,WCR2019_0585,WCR2019_0122,within-group subordinate,within-group subordinate,286,236,50,7,44,243,280,1,99999,8235,8195,8171,0.0875408645114421,0,0,NA,NA,none,hothiphop.parents,hot.parents
2019,1,WCR2019_1359,2,WCR2019_0585,WCR2019_0327,within-group subordinate,within-group subordinate,290,257,33,7,27,264,284,1,99999,8235,8112,8089,0.0875408645114421,0,0,NA,NA,none,hothiphop.parents,hot.parents
2019,1,WCR2019_1359,3,WCR2019_0585,WCR2019_0641,within-group subordinate,within-group subordinate,290,184,106,7,101,191,285,1,99999,8235,6103,6083,0.0875408645114421,0,0,NA,NA,none,hothiphop.parents,hot.parents
2019,1,WCR2019_1360,1,WCR2019_0223,WCR2019_0641,within-group subordinate,within-group subordinate,172,141,31,21,32,162,173,1,99999,5009,5026,3795,0.114180206794682,0,0,NA,NA,none,hothiphop.parents,hot.parents
2019,1,WCR2019_1360,2,WCR2019_0223,WCR2019_0537,within-group subordinate,within-group subordinate,186,161,25,21,7,182,168,1,99999,5009,6761,5004,0.114180206794682,0,0,NA,NA,none,hothiphop.parents,hot.parents
2019,1,WCR2019_1360,3,WCR2019_0223,WCR2019_0327,within-group subordinate,within-group subordinate,191,170,21,21,4,191,174,1,99999,5009,6648,4937,0.114180206794682,0,0,NA,NA,none,hothiphop.parents,hot.parents
2019,1,WCR2019_1361,1,WCR2019_0223,WCR2019_0641,within-group subordinate,within-group subordinate,318,254,64,32,66,286,320,1,99999,5805,5873,4376,0.0898550724637681,0,0,NA,NA,none,hothiphop.parents,hot.parents
2019,1,WCR2019_1361,2,WCR2019_0223,WCR2019_0327,within-group subordinate,within-group subordinate,326,289,37,32,13,321,302,1,99999,5805,7793,5727,0.0898550724637681,0,0,NA,NA,none,hothiphop.parents,hot.parents
2019,1,WCR2019_1361,3,WCR2019_0223,WCR2019_0087,within-group subordinate,within-group subordinate,327,277,50,32,44,309,321,1,99999,5805,6944,5047,0.0898550724637681,0,0,NA,NA,none,hothiphop.parents,hot.parents
2019,1,WCR2019_1363,1,WCR2019_0223,WCR2019_0641,within-group subordinate,within-group subordinate,221,186,35,32,26,218,212,1,99999,5976,6052,4486,0.145102339181287,0,0,NA,NA,none,hothiphop.parents,hot.parents
2019,1,WCR2019_1363,2,WCR2019_0008,WCR2019_0641,within-group subordinate,within-group subordinate,251,224,27,12,26,236,250,1,99999,8074,6052,5967,0.145102339181287,0,0,NA,NA,none,hothiphop.parents,hot.parents
2019,1,WCR2019_1363,3,WCR2019_0223,WCR2019_0075,within-group subordinate,within-group subordinate,253,220,33,32,15,252,235,1,99999,5976,7665,5545,0.145102339181287,0,0,NA,NA,none,hothiphop.parents,hot.parents
2019,1,WCR2019_1365,1,WCR2019_0223,WCR2019_0641,within-group subordinate,within-group subordinate,218,146,72,90,25,236,171,1,99999,5933,6017,4461,0.135118535806412,0,0,NA,NA,none,hothiphop.parents,hot.parents
2019,1,WCR2019_1365,2,WCR2019_0488,WCR2019_0641,within-group subordinate,within-group subordinate,224,193,31,11,25,204,218,1,99999,8106,6017,5994,0.135118535806412,0,0,NA,NA,none,hothiphop.parents,hot.parents
2019,1,WCR2019_1365,3,WCR2019_0008,WCR2019_0641,within-group subordinate,within-group subordinate,225,198,27,7,25,205,223,1,99999,8007,6017,5933,0.135118535806412,0,0,NA,NA,none,hothiphop.parents,hot.parents
2019,1,WCR2019_1367,1,WCR2019_0223,WCR2019_0641,within-group subordinate,within-group subordinate,365,286,79,48,83,334,369,1,99999,6047,6147,4538,0.114484579383175,0,0,NA,NA,none,hothiphop.parents,hot.parents
2019,1,WCR2019_1367,2,WCR2019_0223,WCR2019_0075,within-group subordinate,within-group subordinate,397,331,66,48,53,379,384,1,99999,6047,7790,5616,0.114484579383175,0,0,NA,NA,none,hothiphop.parents,hot.parents
2019,1,WCR2019_1367,3,WCR2019_0223,WCR2019_0327,within-group subordinate,within-group subordinate,398,343,55,48,26,391,369,1,99999,6047,8182,5961,0.114484579383175,0,0,NA,NA,none,hothiphop.parents,hot.parents
2019,1,WCR2019_1368,1,WCR2019_0223,WCR2019_0641,within-group subordinate,within-group subordinate,339,262,77,48,82,310,344,1,99999,5975,6062,4489,0.0982588579081943,0,0,NA,NA,none,hothiphop.parents,hot.parents
2019,1,WCR2019_1368,2,WCR2019_0223,WCR2019_0327,within-group subordinate,within-group subordinate,359,306,53,48,26,354,332,1,99999,5975,8069,5892,0.0982588579081943,0,0,NA,NA,none,hothiphop.parents,hot.parents
2019,1,WCR2019_1368,3,WCR2019_0223,WCR2019_0075,within-group subordinate,within-group subordinate,365,296,69,48,60,344,356,1,99999,5975,7673,5548,0.0982588579081943,0,0,NA,NA,none,hothiphop.parents,hot.parents
2019,1,WCR2019_1369,1,WCR2019_0194,WCR2019_0327,within-group subordinate,within-group subordinate,200,183,17,2,15,185,198,1,99999,7937,7850,7802,0.0949937421777221,0,0,NA,NA,none,hothiphop.parents,hot.parents
2019,1,WCR2019_1369,2,WCR2019_0194,WCR2019_0122,within-group subordinate,within-group subordinate,200,170,30,2,28,172,198,1,99999,7937,7924,7871,0.0949937421777221,0,0,NA,NA,none,hothiphop.parents,hot.parents
2019,1,WCR2019_1369,3,WCR2019_0194,WCR2019_0161,within-group subordinate,within-group subordinate,221,189,32,2,30,191,219,1,99999,7937,7865,7814,0.0949937421777221,0,0,NA,NA,none,hothiphop.parents,hot.parents
2019,1,WCR2019_1370,1,WCR2019_0534,WCR2019_0447,within-group subordinate,within-group subordinate,20,8,12,5,7,13,15,1,99999,8335,8311,8281,0.139988045427376,0,0,NA,NA,none,hothiphop.parents,hot.parents
2019,1,WCR2019_1370,2,WCR2019_0008,WCR2019_0447,within-group subordinate,within-group subordinate,178,153,25,20,7,173,160,1,99999,8228,8311,8174,0.139988045427376,0,0,NA,NA,none,hothiphop.parents,hot.parents
2019,1,WCR2019_1370,3,WCR2019_0256,WCR2019_0447,within-group subordinate,within-group subordinate,188,160,28,25,7,185,167,1,99999,8301,8311,8248,0.139988045427376,0,0,NA,NA,none,hothiphop.parents,hot.parents
2019,1,WCR2019_1371,1,WCR2019_0223,WCR2019_0641,within-group subordinate,within-group subordinate,331,246,85,59,83,305,329,1,99999,6003,6092,4507,0.0846554438658108,0,0,NA,NA,none,hothiphop.parents,hot.parents
2019,1,WCR2019_1371,2,WCR2019_0126,WCR2019_0641,within-group subordinate,within-group subordinate,351,216,135,148,83,364,299,1,99999,5237,6092,3905,0.0846554438658108,0,0,NA,NA,none,hothiphop.parents,hot.parents
2019,1,WCR2019_1371,3,WCR2019_0223,WCR2019_0087,within-group subordinate,within-group subordinate,353,281,72,59,65,340,346,1,99999,6003,7202,5211,0.0846554438658108,0,0,NA,NA,none,hothiphop.parents,hot.parents
2019,1,WCR2019_1372,1,WCR2019_0008,WCR2019_0299,within-group subordinate,within-group subordinate,220,187,33,27,6,214,193,1,99999,8014,8117,7985,0.0957525165725509,0,0,NA,NA,none,hothiphop.parents,hot.parents
2019,1,WCR2019_1372,2,WCR2019_0256,WCR2019_0299,within-group subordinate,within-group subordinate,221,176,45,40,6,216,182,1,99999,8088,8117,8060,0.0957525165725509,0,0,NA,NA,none,hothiphop.parents,hot.parents
2019,1,WCR2019_1372,3,WCR2019_0595,WCR2019_0299,within-group subordinate,within-group subordinate,227,186,41,37,6,223,192,1,99999,8132,8117,8103,0.0957525165725509,0,0,NA,NA,none,hothiphop.parents,hot.parents
2019,1,WCR2019_1373,1,WCR2019_0008,WCR2019_0641,within-group subordinate,within-group subordinate,210,178,32,22,24,200,202,1,99999,8126,6096,6012,0.118174113088752,0,0,NA,NA,none,hothiphop.parents,hot.parents
2019,1,WCR2019_1373,2,WCR2019_0441,WCR2019_0641,within-group subordinate,within-group subordinate,215,190,25,6,24,196,214,1,99999,8238,6096,6080,0.118174113088752,0,0,NA,NA,none,hothiphop.parents,hot.parents
2019,1,WCR2019_1373,3,WCR2019_0008,WCR2019_0405,within-group subordinate,within-group subordinate,216,192,24,22,4,214,196,1,99999,8126,8098,7967,0.118174113088752,0,0,NA,NA,none,hothiphop.parents,hot.parents
2019,1,WCR2019_1375,1,WCR2019_0223,WCR2019_0641,within-group subordinate,within-group subordinate,191,174,17,18,10,192,184,1,99999,6007,6094,4508,0.173828834281564,0,0,NA,NA,none,hothiphop.parents,hot.parents
2019,1,WCR2019_1375,2,WCR2019_0223,WCR2019_0088,within-group subordinate,within-group subordinate,204,190,14,18,2,208,192,1,99999,6007,7298,5293,0.173828834281564,0,0,NA,NA,none,hothiphop.parents,hot.parents
2019,1,WCR2019_1375,3,WCR2019_0223,WCR2019_0327,within-group subordinate,within-group subordinate,206,184,22,18,5,202,189,1,99999,6007,8113,5923,0.173828834281564,0,0,NA,NA,none,hothiphop.parents,hot.parents
2019,1,WCR2019_1376,1,WCR2019_0223,WCR2019_0641,within-group subordinate,within-group subordinate,325,253,72,45,76,298,329,1,99999,6027,6126,4526,0.102783467887697,0,0,NA,NA,none,hothiphop.parents,hot.parents
2019,1,WCR2019_1376,2,WCR2019_0223,WCR2019_0087,within-group subordinate,within-group subordinate,360,295,65,45,55,340,350,1,99999,6027,7242,5235,0.102783467887697,0,0,NA,NA,none,hothiphop.parents,hot.parents
2019,1,WCR2019_1376,3,WCR2019_0126,WCR2019_0641,within-group subordinate,within-group subordinate,363,240,123,129,76,369,316,1,99999,5258,6126,3921,0.102783467887697,0,0,NA,NA,none,hothiphop.parents,hot.parents
2019,1,WCR2019_1377,1,WCR2019_0223,WCR2019_0641,within-group subordinate,within-group subordinate,312,264,48,38,53,302,317,1,99999,6034,6136,4532,0.123661734632503,0,0,NA,NA,none,hothiphop.parents,hot.parents
2019,1,WCR2019_1377,2,WCR2019_0223,WCR2019_0075,within-group subordinate,within-group subordinate,330,282,48,38,50,320,332,1,99999,6034,7768,5603,0.123661734632503,0,0,NA,NA,none,hothiphop.parents,hot.parents
2019,1,WCR2019_1377,3,WCR2019_0223,WCR2019_0327,within-group subordinate,within-group subordinate,335,295,40,38,28,333,323,1,99999,6034,8162,5948,0.123661734632503,0,0,NA,NA,none,hothiphop.parents,hot.parents
2019,1,WCR2019_1378,1,WCR2019_0421,WCR2019_0258,within-group subordinate,within-group subordinate,8,4,4,0,4,4,8,1,99999,7637,7589,7573,0.119038285639618,0,0,NA,NA,none,hothiphop.parents,hot.parents
2019,1,WCR2019_1378,2,WCR2019_0421,WCR2019_0327,within-group subordinate,within-group subordinate,114,107,7,0,7,107,114,1,99999,7637,7515,7500,0.119038285639618,0,0,NA,NA,none,hothiphop.parents,hot.parents
2019,1,WCR2019_1378,3,WCR2019_0421,WCR2019_0233,within-group subordinate,within-group subordinate,128,117,11,0,11,117,128,1,99999,7637,7591,7577,0.119038285639618,0,0,NA,NA,none,hothiphop.parents,hot.parents
2019,1,WCR2019_1379,1,WCR2019_0223,WCR2019_0641,within-group subordinate,within-group subordinate,305,244,61,35,55,279,299,1,99999,5780,5892,4367,0.103891197582168,0,0,NA,NA,none,hothiphop.parents,hot.parents
2019,1,WCR2019_1379,2,WCR2019_0223,WCR2019_0327,within-group subordinate,within-group subordinate,330,285,45,35,19,320,304,1,99999,5780,7797,5699,0.103891197582168,0,0,NA,NA,none,hothiphop.parents,hot.parents
2019,1,WCR2019_1379,3,WCR2019_0223,WCR2019_0075,within-group subordinate,within-group subordinate,333,277,56,35,51,312,328,1,99999,5780,7424,5366,0.103891197582168,0,0,NA,NA,none,hothiphop.parents,hot.parents
2019,1,WCR2019_1380,1,WCR2019_0223,WCR2019_0641,within-group subordinate,within-group subordinate,330,254,76,44,82,298,336,1,99999,5882,5963,4426,0.0943770126331434,0,0,NA,NA,none,hothiphop.parents,hot.parents
2019,1,WCR2019_1380,2,WCR2019_0567,WCR2019_0641,within-group subordinate,within-group subordinate,331,237,94,33,82,270,319,1,99999,7990,5963,5903,0.0943770126331434,0,0,NA,NA,none,hothiphop.parents,hot.parents
2019,1,WCR2019_1380,3,WCR2019_0223,WCR2019_0087,within-group subordinate,within-group subordinate,352,298,54,44,46,342,344,1,99999,5882,7039,5099,0.0943770126331434,0,0,NA,NA,none,hothiphop.parents,hot.parents
2019,1,WCR2019_1381,1,WCR2019_0223,WCR2019_0641,within-group subordinate,within-group subordinate,227,202,25,23,8,225,210,1,99999,6033,6131,4534,0.177207565353572,0,0,NA,NA,none,hothiphop.parents,hot.parents
2019,1,WCR2019_1381,2,WCR2019_0223,WCR2019_0088,within-group subordinate,within-group subordinate,242,224,18,23,2,247,226,1,99999,6033,7332,5315,0.177207565353572,0,0,NA,NA,none,hothiphop.parents,hot.parents
2019,1,WCR2019_1381,3,WCR2019_0223,WCR2019_0075,within-group subordinate,within-group subordinate,257,233,24,23,4,256,237,1,99999,6033,7757,5602,0.177207565353572,0,0,NA,NA,none,hothiphop.parents,hot.parents
2019,1,WCR2019_1383,1,WCR2019_0256,WCR2019_0405,within-group subordinate,within-group subordinate,62,50,12,12,0,62,50,1,99999,8160,8060,8001,0.0261557177615572,0,0,NA,NA,none,hothiphop.parents,hot.parents
2019,1,WCR2019_1383,2,WCR2019_0474,WCR2019_0405,within-group subordinate,within-group subordinate,63,51,12,12,0,63,51,1,99999,7891,8060,7748,0.0261557177615572,0,0,NA,NA,none,hothiphop.parents,hot.parents
2019,1,WCR2019_1383,3,WCR2019_0489,WCR2019_0405,within-group subordinate,within-group subordinate,64,51,13,13,0,64,51,1,99999,8189,8060,8029,0.0261557177615572,0,0,NA,NA,none,hothiphop.parents,hot.parents
2019,1,WCR2019_1384,1,WCR2019_0223,WCR2019_0641,within-group subordinate,within-group subordinate,213,182,31,26,29,208,211,1,99999,5947,6051,4468,0.138956606533398,0,0,NA,NA,none,hothiphop.parents,hot.parents
2019,1,WCR2019_1384,2,WCR2019_0380,WCR2019_0641,within-group subordinate,within-group subordinate,238,191,47,35,29,226,220,1,99999,8149,6051,6010,0.138956606533398,0,0,NA,NA,none,hothiphop.parents,hot.parents
2019,1,WCR2019_1384,3,WCR2019_0583,WCR2019_0122,within-group subordinate,within-group subordinate,247,202,45,37,11,239,213,1,99999,8179,8142,8118,0.138956606533398,0,0,NA,NA,none,hothiphop.parents,hot.parents
2019,1,WCR2019_1385,1,WCR2019_0223,WCR2019_0602,within-group subordinate,within-group subordinate,266,216,50,49,4,265,220,1,99999,6011,8226,5985,0.121157104817236,0,0,NA,NA,none,hothiphop.parents,hot.parents
2019,1,WCR2019_1385,2,WCR2019_0076,WCR2019_0602,within-group subordinate,within-group subordinate,286,228,58,56,4,284,232,1,99999,7103,8226,7069,0.121157104817236,0,0,NA,NA,none,hothiphop.parents,hot.parents
2019,1,WCR2019_1385,3,WCR2019_0440,WCR2019_0602,within-group subordinate,within-group subordinate,296,235,61,59,4,294,239,1,99999,6874,8226,6846,0.121157104817236,0,0,NA,NA,none,hothiphop.parents,hot.parents
2019,1,WCR2019_1387,1,WCR2019_0223,WCR2019_0461,within-group subordinate,within-group subordinate,261,203,58,55,5,258,208,1,99999,6054,8312,6034,0.105868263473054,0,0,NA,NA,none,hothiphop.parents,hot.parents
2019,1,WCR2019_1387,2,WCR2019_0008,WCR2019_0461,within-group subordinate,within-group subordinate,284,230,54,50,5,280,235,1,99999,8213,8312,8176,0.105868263473054,0,0,NA,NA,none,hothiphop.parents,hot.parents
2019,1,WCR2019_1387,3,WCR2019_0440,WCR2019_0461,within-group subordinate,within-group subordinate,288,230,58,54,5,284,235,1,99999,6940,8312,6914,0.105868263473054,0,0,NA,NA,none,hothiphop.parents,hot.parents
2019,1,WCR2019_1388,1,WCR2019_0223,WCR2019_0641,within-group subordinate,within-group subordinate,312,251,61,30,74,281,325,1,99999,6027,6122,4521,0.112182190625377,0,0,NA,NA,none,hothiphop.parents,hot.parents
2019,1,WCR2019_1388,2,WCR2019_0223,WCR2019_0327,within-group subordinate,within-group subordinate,331,291,40,30,21,321,312,1,99999,6027,8153,5943,0.112182190625377,0,0,NA,NA,none,hothiphop.parents,hot.parents
2019,1,WCR2019_1388,3,WCR2019_0223,WCR2019_0087,within-group subordinate,within-group subordinate,335,286,49,30,41,316,327,1,99999,6027,7241,5234,0.112182190625377,0,0,NA,NA,none,hothiphop.parents,hot.parents
2019,1,WCR2019_1389,1,WCR2019_0223,WCR2019_0641,within-group subordinate,within-group subordinate,205,168,37,37,16,205,184,1,99999,6071,6172,4557,0.16491395793499,0,0,NA,NA,none,hothiphop.parents,hot.parents
2019,1,WCR2019_1389,2,WCR2019_0441,WCR2019_0641,within-group subordinate,within-group subordinate,225,208,17,3,16,211,224,1,99999,8346,6172,6156,0.16491395793499,0,0,NA,NA,none,hothiphop.parents,hot.parents
2019,1,WCR2019_1389,3,WCR2019_0361,WCR2019_0641,within-group subordinate,within-group subordinate,232,215,17,6,16,221,231,1,99999,7981,6172,5916,0.16491395793499,0,0,NA,NA,none,hothiphop.parents,hot.parents
2019,1,WCR2019_1390,1,WCR2019_0223,WCR2019_0641,within-group subordinate,within-group subordinate,281,214,67,47,68,261,282,1,99999,6022,6118,4523,0.114878725714975,0,0,NA,NA,none,hothiphop.parents,hot.parents
2019,1,WCR2019_1390,2,WCR2019_0223,WCR2019_0327,within-group subordinate,within-group subordinate,319,271,48,47,24,318,295,1,99999,6022,8139,5939,0.114878725714975,0,0,NA,NA,none,hothiphop.parents,hot.parents
2019,1,WCR2019_1390,3,WCR2019_0446,WCR2019_0641,within-group subordinate,within-group subordinate,320,240,80,23,68,263,308,1,99999,8212,6118,6068,0.114878725714975,0,0,NA,NA,none,hothiphop.parents,hot.parents
2019,1,WCR2019_1392,1,WCR2019_0223,WCR2019_0641,within-group subordinate,within-group subordinate,253,200,53,37,45,237,245,1,99999,6060,6167,4556,0.132662835249042,0,0,NA,NA,none,hothiphop.parents,hot.parents
2019,1,WCR2019_1392,2,WCR2019_0223,WCR2019_0327,within-group subordinate,within-group subordinate,264,223,41,37,16,260,239,1,99999,6060,8202,5975,0.132662835249042,0,0,NA,NA,none,hothiphop.parents,hot.parents
2019,1,WCR2019_1392,3,WCR2019_0593,WCR2019_0641,within-group subordinate,within-group subordinate,280,221,59,39,45,260,266,1,99999,8322,6167,6146,0.132662835249042,0,0,NA,NA,none,hothiphop.parents,hot.parents
2019,1,WCR2019_1394,1,WCR2019_0223,WCR2019_0641,within-group subordinate,within-group subordinate,293,223,70,42,81,265,304,1,99999,6057,6155,4551,0.113802614222329,0,0,NA,NA,none,hothiphop.parents,hot.parents
2019,1,WCR2019_1394,2,WCR2019_0223,WCR2019_0327,within-group subordinate,within-group subordinate,305,256,49,42,22,298,278,1,99999,6057,8191,5973,0.113802614222329,0,0,NA,NA,none,hothiphop.parents,hot.parents
2019,1,WCR2019_1394,3,WCR2019_0223,WCR2019_0075,within-group subordinate,within-group subordinate,312,255,57,42,47,297,302,1,99999,6057,7794,5626,0.113802614222329,0,0,NA,NA,none,hothiphop.parents,hot.parents
2019,1,WCR2019_1395,1,WCR2019_0223,WCR2019_0641,within-group subordinate,within-group subordinate,250,203,47,33,49,236,252,1,99999,6028,6119,4522,0.120916214587101,0,0,NA,NA,none,hothiphop.parents,hot.parents
2019,1,WCR2019_1395,2,WCR2019_0223,WCR2019_0061,within-group subordinate,within-group subordinate,267,227,40,33,37,260,264,1,99999,6028,7850,5687,0.120916214587101,0,0,NA,NA,none,hothiphop.parents,hot.parents
2019,1,WCR2019_1395,3,WCR2019_0223,WCR2019_0075,within-group subordinate,within-group subordinate,273,233,40,33,41,266,274,1,99999,6028,7751,5596,0.120916214587101,0,0,NA,NA,none,hothiphop.parents,hot.parents
2019,1,WCR2019_1396,1,WCR2019_0479,WCR2019_0641,within-group subordinate,within-group subordinate,117,102,15,1,14,103,116,1,99999,6232,4692,4676,0.120102350871582,0,0,NA,NA,none,hothiphop.parents,hot.parents
2019,1,WCR2019_1396,2,WCR2019_0479,WCR2019_0206,within-group subordinate,within-group subordinate,119,112,7,1,6,113,118,1,99999,6232,6209,6189,0.120102350871582,0,0,NA,NA,none,hothiphop.parents,hot.parents
2019,1,WCR2019_1396,3,WCR2019_0479,WCR2019_0122,within-group subordinate,within-group subordinate,123,120,3,1,2,121,122,1,99999,6232,6207,6186,0.120102350871582,0,0,NA,NA,none,hothiphop.parents,hot.parents
2019,1,WCR2019_1397,1,WCR2019_0399,WCR2019_0088,within-group subordinate,within-group subordinate,124,102,22,12,15,114,117,1,99999,8070,7154,7140,0.0685134800890428,0,0,NA,NA,none,hothiphop.parents,hot.parents
2019,1,WCR2019_1397,2,WCR2019_0474,WCR2019_0122,within-group subordinate,within-group subordinate,130,112,18,8,12,120,124,1,99999,7771,8023,7709,0.0685134800890428,0,0,NA,NA,none,hothiphop.parents,hot.parents
2019,1,WCR2019_1397,3,WCR2019_0165,WCR2019_0088,within-group subordinate,within-group subordinate,131,112,19,8,15,120,127,1,99999,8063,7154,7137,0.0685134800890428,0,0,NA,NA,none,hothiphop.parents,hot.parents
2019,1,WCR2019_1398,1,WCR2019_0474,WCR2019_0537,within-group subordinate,within-group subordinate,47,39,8,6,2,45,41,1,99999,7556,7844,7542,0.0909900738101298,0,0,NA,NA,none,hothiphop.parents,hot.parents
2019,1,WCR2019_1398,2,WCR2019_0535,WCR2019_0537,within-group subordinate,within-group subordinate,55,45,10,9,2,54,47,1,99999,7835,7844,7821,0.0909900738101298,0,0,NA,NA,none,hothiphop.parents,hot.parents
2019,1,WCR2019_1398,3,WCR2019_0324,WCR2019_0537,within-group subordinate,within-group subordinate,57,48,9,7,2,55,50,1,99999,7847,7844,7833,0.0909900738101298,0,0,NA,NA,none,hothiphop.parents,hot.parents
2019,1,WCR2019_1399,1,WCR2019_0474,WCR2019_0405,within-group subordinate,within-group subordinate,49,40,9,10,0,50,40,1,99999,7710,7867,7578,0.0237085101073122,0,0,NA,NA,none,hothiphop.parents,hot.parents
2019,1,WCR2019_1399,2,WCR2019_0409,WCR2019_0405,within-group subordinate,within-group subordinate,51,39,12,13,0,52,39,1,99999,7987,7867,7842,0.0237085101073122,0,0,NA,NA,none,hothiphop.parents,hot.parents
2019,1,WCR2019_1399,3,WCR2019_0326,WCR2019_0405,within-group subordinate,within-group subordinate,52,40,12,12,0,52,40,1,99999,7982,7867,7835,0.0237085101073122,0,0,NA,NA,none,hothiphop.parents,hot.parents
2019,1,WCR2019_1400,1,WCR2019_0223,WCR2019_0641,within-group subordinate,within-group subordinate,349,279,70,48,64,327,343,1,99999,5994,6081,4507,0.114473204520598,0,0,NA,NA,none,hothiphop.parents,hot.parents
2019,1,WCR2019_1400,2,WCR2019_0126,WCR2019_0641,within-group subordinate,within-group subordinate,368,260,108,116,64,376,324,1,99999,5223,6081,3901,0.114473204520598,0,0,NA,NA,none,hothiphop.parents,hot.parents
2019,1,WCR2019_1400,3,WCR2019_0223,WCR2019_0087,within-group subordinate,within-group subordinate,372,311,61,48,44,359,355,1,99999,5994,7174,5202,0.114473204520598,0,0,NA,NA,none,hothiphop.parents,hot.parents
2019,1,WCR2019_1401,1,WCR2019_0223,WCR2019_0257,within-group subordinate,within-group subordinate,251,199,52,50,5,249,204,1,99999,5955,8160,5937,0.140119614304894,0,0,NA,NA,none,hothiphop.parents,hot.parents
2019,1,WCR2019_1401,2,WCR2019_0223,WCR2019_0641,within-group subordinate,within-group subordinate,267,218,49,50,46,268,264,1,99999,5955,6041,4471,0.140119614304894,0,0,NA,NA,none,hothiphop.parents,hot.parents
2019,1,WCR2019_1401,3,WCR2019_0008,WCR2019_0257,within-group subordinate,within-group subordinate,276,251,25,23,5,274,256,1,99999,8059,8160,8026,0.140119614304894,0,0,NA,NA,none,hothiphop.parents,hot.parents
2019,1,WCR2019_1402,1,WCR2019_0223,WCR2019_0641,within-group subordinate,within-group subordinate,130,119,11,10,6,129,125,1,99999,4312,4179,3319,0.156894679695983,0,0,NA,NA,none,hothiphop.parents,hot.parents
2019,1,WCR2019_1402,2,WCR2019_0008,WCR2019_0641,within-group subordinate,within-group subordinate,143,136,7,4,6,140,142,1,99999,5441,4179,4122,0.156894679695983,0,0,NA,NA,none,hothiphop.parents,hot.parents
2019,1,WCR2019_1402,3,WCR2019_0223,WCR2019_0075,within-group subordinate,within-group subordinate,143,133,10,10,3,143,136,1,99999,4312,5152,4002,0.156894679695983,0,0,NA,NA,none,hothiphop.parents,hot.parents
2019,1,WCR2019_1405,1,WCR2019_0223,WCR2019_0641,within-group subordinate,within-group subordinate,294,233,61,42,56,275,289,1,99999,6036,6128,4528,0.126955475330927,0,0,NA,NA,none,hothiphop.parents,hot.parents
2019,1,WCR2019_1405,2,WCR2019_0223,WCR2019_0327,within-group subordinate,within-group subordinate,320,274,46,42,21,316,295,1,99999,6036,8167,5954,0.126955475330927,0,0,NA,NA,none,hothiphop.parents,hot.parents
2019,1,WCR2019_1405,3,WCR2019_0126,WCR2019_0641,within-group subordinate,within-group subordinate,324,215,109,116,56,331,271,1,99999,5273,6128,3931,0.126955475330927,0,0,NA,NA,none,hothiphop.parents,hot.parents
2019,1,WCR2019_1406,1,WCR2019_0223,WCR2019_0641,within-group subordinate,within-group subordinate,250,215,35,30,27,245,242,1,99999,6053,6145,4544,0.153799975987514,0,0,NA,NA,none,hothiphop.parents,hot.parents
2019,1,WCR2019_1406,2,WCR2019_0223,WCR2019_0327,within-group subordinate,within-group subordinate,270,235,35,30,17,265,252,1,99999,6053,8180,5967,0.153799975987514,0,0,NA,NA,none,hothiphop.parents,hot.parents
2019,1,WCR2019_1406,3,WCR2019_0223,WCR2019_0161,within-group subordinate,within-group subordinate,270,225,45,30,33,255,258,1,99999,6053,8195,5958,0.153799975987514,0,0,NA,NA,none,hothiphop.parents,hot.parents
2019,1,WCR2019_1407,1,WCR2019_0532,WCR2019_0327,within-group subordinate,within-group subordinate,289,264,25,2,23,266,287,1,99999,8231,8144,8084,0.0980226669881842,0,0,NA,NA,none,hothiphop.parents,hot.parents
2019,1,WCR2019_1407,2,WCR2019_0532,WCR2019_0122,within-group subordinate,within-group subordinate,297,261,36,2,35,263,296,1,99999,8231,8230,8168,0.0980226669881842,0,0,NA,NA,none,hothiphop.parents,hot.parents
2019,1,WCR2019_1407,3,WCR2019_0532,WCR2019_0475,within-group subordinate,within-group subordinate,299,233,66,2,64,235,297,1,99999,8231,8267,8204,0.0980226669881842,0,0,NA,NA,none,hothiphop.parents,hot.parents
2019,1,WCR2019_1409,1,WCR2019_0223,WCR2019_0641,within-group subordinate,within-group subordinate,304,188,116,116,54,304,242,1,99999,6045,6147,4542,0.116142205140524,0,0,NA,NA,none,hothiphop.parents,hot.parents
2019,1,WCR2019_1409,2,WCR2019_0008,WCR2019_0641,within-group subordinate,within-group subordinate,324,261,63,37,54,298,315,1,99999,8192,6147,6063,0.116142205140524,0,0,NA,NA,none,hothiphop.parents,hot.parents
2019,1,WCR2019_1409,3,WCR2019_0361,WCR2019_0641,within-group subordinate,within-group subordinate,325,265,60,37,54,302,319,1,99999,7946,6147,5895,0.116142205140524,0,0,NA,NA,none,hothiphop.parents,hot.parents
2019,1,WCR2019_1411,1,WCR2019_0223,WCR2019_0537,within-group subordinate,within-group subordinate,283,227,56,49,27,276,254,1,99999,6064,8339,6053,0.129472298671772,0,0,NA,NA,none,hothiphop.parents,hot.parents
2019,1,WCR2019_1411,2,WCR2019_0223,WCR2019_0641,within-group subordinate,within-group subordinate,285,221,64,49,62,270,283,1,99999,6064,6169,4556,0.129472298671772,0,0,NA,NA,none,hothiphop.parents,hot.parents
2019,1,WCR2019_1411,3,WCR2019_0440,WCR2019_0537,within-group subordinate,within-group subordinate,299,247,52,42,27,289,274,1,99999,6947,8339,6933,0.129472298671772,0,0,NA,NA,none,hothiphop.parents,hot.parents
2019,1,WCR2019_1412,1,WCR2019_0223,WCR2019_0641,within-group subordinate,within-group subordinate,346,259,87,58,96,317,355,1,99999,6048,6152,4544,0.0992201559688062,0,0,NA,NA,none,hothiphop.parents,hot.parents
2019,1,WCR2019_1412,2,WCR2019_0223,WCR2019_0087,within-group subordinate,within-group subordinate,367,302,65,58,46,360,348,1,99999,6048,7278,5254,0.0992201559688062,0,0,NA,NA,none,hothiphop.parents,hot.parents
2019,1,WCR2019_1412,3,WCR2019_0223,WCR2019_0073,within-group subordinate,within-group subordinate,384,318,66,58,47,376,365,1,99999,6048,7944,5729,0.0992201559688062,0,0,NA,NA,none,hothiphop.parents,hot.parents
2019,1,WCR2019_1413,1,WCR2019_0223,WCR2019_0641,within-group subordinate,within-group subordinate,353,269,84,50,90,319,359,1,99999,6002,6080,4509,0.0943419135502671,0,0,NA,NA,none,hothiphop.parents,hot.parents
2019,1,WCR2019_1413,2,WCR2019_0223,WCR2019_0087,within-group subordinate,within-group subordinate,356,295,61,50,46,345,341,1,99999,6002,7184,5213,0.0943419135502671,0,0,NA,NA,none,hothiphop.parents,hot.parents
2019,1,WCR2019_1413,3,WCR2019_0223,WCR2019_0073,within-group subordinate,within-group subordinate,377,314,63,50,43,364,357,1,99999,6002,7849,5687,0.0943419135502671,0,0,NA,NA,none,hothiphop.parents,hot.parents
2019,1,WCR2019_1414,1,WCR2019_0223,WCR2019_0641,within-group subordinate,within-group subordinate,217,194,23,19,14,213,208,1,99999,6017,6110,4516,0.173934050006039,0,0,NA,NA,none,hothiphop.parents,hot.parents
2019,1,WCR2019_1414,2,WCR2019_0223,WCR2019_0075,within-group subordinate,within-group subordinate,229,209,20,19,3,228,212,1,99999,6017,7734,5585,0.173934050006039,0,0,NA,NA,none,hothiphop.parents,hot.parents
2019,1,WCR2019_1414,3,WCR2019_0223,WCR2019_0088,within-group subordinate,within-group subordinate,230,214,16,19,4,233,218,1,99999,6017,7312,5300,0.173934050006039,0,0,NA,NA,none,hothiphop.parents,hot.parents
2019,1,WCR2019_1415,1,WCR2019_0223,WCR2019_0641,within-group subordinate,within-group subordinate,303,252,51,36,56,288,308,1,99999,5989,6078,4498,0.122327502429543,0,0,NA,NA,none,hothiphop.parents,hot.parents
2019,1,WCR2019_1415,2,WCR2019_0223,WCR2019_0327,within-group subordinate,within-group subordinate,351,311,40,36,16,347,327,1,99999,5989,8086,5905,0.122327502429543,0,0,NA,NA,none,hothiphop.parents,hot.parents
2019,1,WCR2019_1415,3,WCR2019_0223,WCR2019_0122,within-group subordinate,within-group subordinate,362,308,54,36,37,344,345,1,99999,5989,8167,5940,0.122327502429543,0,0,NA,NA,none,hothiphop.parents,hot.parents
2019,1,WCR2019_1416,1,WCR2019_0330,WCR2019_0641,within-group subordinate,within-group subordinate,253,214,39,7,34,221,248,1,99999,8143,6043,6028,0.134189602446483,0,0,NA,NA,none,hothiphop.parents,hot.parents
2019,1,WCR2019_1416,2,WCR2019_0223,WCR2019_0641,within-group subordinate,within-group subordinate,260,222,38,31,34,253,256,1,99999,5946,6043,4470,0.134189602446483,0,0,NA,NA,none,hothiphop.parents,hot.parents
2019,1,WCR2019_1416,3,WCR2019_0330,WCR2019_0327,within-group subordinate,within-group subordinate,275,256,19,7,12,263,268,1,99999,8143,8032,8002,0.134189602446483,0,0,NA,NA,none,hothiphop.parents,hot.parents
2019,1,WCR2019_1418,1,WCR2019_0008,WCR2019_0641,within-group subordinate,within-group subordinate,239,210,29,11,27,221,237,1,99999,8069,6060,5974,0.135543637250122,0,0,NA,NA,none,hothiphop.parents,hot.parents
2019,1,WCR2019_1418,2,WCR2019_0256,WCR2019_0641,within-group subordinate,within-group subordinate,244,216,28,8,27,224,243,1,99999,8142,6060,6016,0.135543637250122,0,0,NA,NA,none,hothiphop.parents,hot.parents
2019,1,WCR2019_1418,3,WCR2019_0223,WCR2019_0641,within-group subordinate,within-group subordinate,246,167,79,95,27,262,194,1,99999,5966,6060,4485,0.135543637250122,0,0,NA,NA,none,hothiphop.parents,hot.parents
2019,1,WCR2019_1419,1,WCR2019_0318,WCR2019_0122,within-group subordinate,within-group subordinate,70,41,29,8,25,49,66,1,99999,7308,7279,7256,0.0863456554358205,0,0,NA,NA,none,hothiphop.parents,hot.parents
2019,1,WCR2019_1419,2,WCR2019_0318,WCR2019_0327,within-group subordinate,within-group subordinate,73,44,29,8,23,52,67,1,99999,7308,7208,7187,0.0863456554358205,0,0,NA,NA,none,hothiphop.parents,hot.parents
2019,1,WCR2019_1419,3,WCR2019_0318,WCR2019_0161,within-group subordinate,within-group subordinate,75,45,30,8,24,53,69,1,99999,7308,7209,7187,0.0863456554358205,0,0,NA,NA,none,hothiphop.parents,hot.parents
2019,1,WCR2019_1420,1,WCR2019_0223,WCR2019_0641,within-group subordinate,within-group subordinate,303,244,59,44,49,288,293,1,99999,6020,6115,4522,0.12139495595511,0,0,NA,NA,none,hothiphop.parents,hot.parents
2019,1,WCR2019_1420,2,WCR2019_0223,WCR2019_0327,within-group subordinate,within-group subordinate,339,292,47,44,27,336,319,1,99999,6020,8138,5936,0.12139495595511,0,0,NA,NA,none,hothiphop.parents,hot.parents
2019,1,WCR2019_1420,3,WCR2019_0126,WCR2019_0641,within-group subordinate,within-group subordinate,342,234,108,120,49,354,283,1,99999,5254,6115,3922,0.12139495595511,0,0,NA,NA,none,hothiphop.parents,hot.parents
2019,1,WCR2019_1421,1,WCR2019_0403,WCR2019_0641,within-group subordinate,within-group subordinate,254,209,45,2,43,211,252,1,99999,8044,6023,5944,0.139862711448885,0,0,NA,NA,none,hothiphop.parents,hot.parents
2019,1,WCR2019_1421,2,WCR2019_0403,WCR2019_0327,within-group subordinate,within-group subordinate,275,258,17,2,15,260,273,1,99999,8044,8015,7902,0.139862711448885,0,0,NA,NA,none,hothiphop.parents,hot.parents
2019,1,WCR2019_1421,3,WCR2019_0403,WCR2019_0087,within-group subordinate,within-group subordinate,276,219,57,2,59,221,278,1,99999,8044,7112,7011,0.139862711448885,0,0,NA,NA,none,hothiphop.parents,hot.parents
2019,1,WCR2019_1422,1,WCR2019_0223,WCR2019_0641,within-group subordinate,within-group subordinate,360,277,83,61,87,338,364,1,99999,6053,6157,4544,0.101114172756679,0,0,NA,NA,none,hothiphop.parents,hot.parents
2019,1,WCR2019_1422,2,WCR2019_0126,WCR2019_0641,within-group subordinate,within-group subordinate,394,264,130,131,87,395,351,1,99999,5292,6157,3946,0.101114172756679,0,0,NA,NA,none,hothiphop.parents,hot.parents
2019,1,WCR2019_1422,3,WCR2019_0076,WCR2019_0641,within-group subordinate,within-group subordinate,400,316,84,55,87,371,403,1,99999,7186,6157,5312,0.101114172756679,0,0,NA,NA,none,hothiphop.parents,hot.parents
2019,1,WCR2019_1423,1,WCR2019_0223,WCR2019_0641,within-group subordinate,within-group subordinate,229,195,34,29,26,224,221,1,99999,5997,6097,4503,0.142442212271572,0,0,NA,NA,none,hothiphop.parents,hot.parents
2019,1,WCR2019_1423,2,WCR2019_0223,WCR2019_0327,within-group subordinate,within-group subordinate,284,252,32,29,23,281,275,1,99999,5997,8115,5913,0.142442212271572,0,0,NA,NA,none,hothiphop.parents,hot.parents
2019,1,WCR2019_1423,3,WCR2019_0223,WCR2019_0075,within-group subordinate,within-group subordinate,291,252,39,29,34,281,286,1,99999,5997,7729,5574,0.142442212271572,0,0,NA,NA,none,hothiphop.parents,hot.parents
2019,1,WCR2019_1424,1,WCR2019_0223,WCR2019_0641,within-group subordinate,within-group subordinate,219,187,32,27,22,214,209,1,99999,5854,5926,4391,0.149614139905402,0,0,NA,NA,none,hothiphop.parents,hot.parents
2019,1,WCR2019_1424,2,WCR2019_0008,WCR2019_0641,within-group subordinate,within-group subordinate,253,225,28,13,22,238,247,1,99999,7901,5926,5842,0.149614139905402,0,0,NA,NA,none,hothiphop.parents,hot.parents
2019,1,WCR2019_1424,3,WCR2019_0223,WCR2019_0327,within-group subordinate,within-group subordinate,257,227,30,27,13,254,240,1,99999,5854,7890,5770,0.149614139905402,0,0,NA,NA,none,hothiphop.parents,hot.parents
2019,1,WCR2019_1425,1,WCR2019_0008,WCR2019_0066,within-group subordinate,within-group subordinate,230,203,27,26,2,229,205,1,99999,8161,8253,8117,0.118100747167992,0,0,NA,NA,none,hothiphop.parents,hot.parents
2019,1,WCR2019_1425,2,WCR2019_0256,WCR2019_0066,within-group subordinate,within-group subordinate,237,197,40,40,2,237,199,1,99999,8235,8253,8190,0.118100747167992,0,0,NA,NA,none,hothiphop.parents,hot.parents
2019,1,WCR2019_1425,3,WCR2019_0310,WCR2019_0066,within-group subordinate,within-group subordinate,242,196,46,46,2,242,198,1,99999,8258,8253,8213,0.118100747167992,0,0,NA,NA,none,hothiphop.parents,hot.parents
2019,1,WCR2019_1477,1,WCR2019_0223,WCR2019_0641,within-group subordinate,within-group subordinate,321,255,66,43,77,298,332,1,99999,6040,6146,4538,0.1109776603411,0,0,NA,NA,none,hothiphop.parents,hot.parents
2019,1,WCR2019_1477,2,WCR2019_0223,WCR2019_0248,within-group subordinate,within-group subordinate,354,289,65,43,38,332,327,1,99999,6040,8255,5994,0.1109776603411,0,0,NA,NA,none,hothiphop.parents,hot.parents
2019,1,WCR2019_1477,3,WCR2019_0223,WCR2019_0087,within-group subordinate,within-group subordinate,362,306,56,43,47,349,353,1,99999,6040,7268,5247,0.1109776603411,0,0,NA,NA,none,hothiphop.parents,hot.parents
2019,1,WCR2019_1478,1,WCR2019_0223,WCR2019_0475,within-group subordinate,within-group subordinate,207,154,53,45,10,199,164,1,99999,6070,8340,6059,0.124447101016139,0,0,NA,NA,none,hothiphop.parents,hot.parents
2019,1,WCR2019_1478,2,WCR2019_0440,WCR2019_0475,within-group subordinate,within-group subordinate,244,173,71,65,10,238,183,1,99999,6955,8340,6936,0.124447101016139,0,0,NA,NA,none,hothiphop.parents,hot.parents
2019,1,WCR2019_1478,3,WCR2019_0008,WCR2019_0475,within-group subordinate,within-group subordinate,264,216,48,40,10,256,226,1,99999,8228,8340,8203,0.124447101016139,0,0,NA,NA,none,hothiphop.parents,hot.parents
2019,1,WCR2019_1479,1,WCR2019_0579,WCR2019_0088,within-group subordinate,within-group subordinate,205,191,14,9,9,200,200,1,99999,8323,7386,7363,0.103378054623862,0,0,NA,NA,none,hothiphop.parents,hot.parents
2019,1,WCR2019_1479,2,WCR2019_0499,WCR2019_0088,within-group subordinate,within-group subordinate,207,193,14,11,9,204,202,1,99999,8307,7386,7349,0.103378054623862,0,0,NA,NA,none,hothiphop.parents,hot.parents
2019,1,WCR2019_1479,3,WCR2019_0333,WCR2019_0088,within-group subordinate,within-group subordinate,209,196,13,8,9,204,205,1,99999,8319,7386,7361,0.103378054623862,0,0,NA,NA,none,hothiphop.parents,hot.parents
2019,1,WCR2019_1480,1,WCR2019_0223,WCR2019_0641,within-group subordinate,within-group subordinate,206,178,28,35,16,213,194,1,99999,6074,6178,4562,0.161610129001433,0,0,NA,NA,none,hothiphop.parents,hot.parents
2019,1,WCR2019_1480,2,WCR2019_0008,WCR2019_0641,within-group subordinate,within-group subordinate,252,231,21,19,16,250,247,1,99999,8235,6178,6091,0.161610129001433,0,0,NA,NA,none,hothiphop.parents,hot.parents
2019,1,WCR2019_1480,3,WCR2019_0223,WCR2019_0075,within-group subordinate,within-group subordinate,257,219,38,35,12,254,231,1,99999,6074,7826,5642,0.161610129001433,0,0,NA,NA,none,hothiphop.parents,hot.parents
2019,1,WCR2019_1482,1,WCR2019_0223,WCR2019_0641,within-group subordinate,within-group subordinate,364,287,77,48,87,335,374,1,99999,6067,6164,4553,0.0968050735910016,0,0,NA,NA,none,hothiphop.parents,hot.parents
2019,1,WCR2019_1482,2,WCR2019_0223,WCR2019_0087,within-group subordinate,within-group subordinate,380,319,61,48,52,367,371,1,99999,6067,7295,5270,0.0968050735910016,0,0,NA,NA,none,hothiphop.parents,hot.parents
2019,1,WCR2019_1482,3,WCR2019_0126,WCR2019_0641,within-group subordinate,within-group subordinate,389,259,130,136,87,395,346,1,99999,5296,6164,3949,0.0968050735910016,0,0,NA,NA,none,hothiphop.parents,hot.parents
2019,1,WCR2019_1483,1,WCR2019_0219,WCR2019_0087,within-group subordinate,within-group subordinate,364,317,47,30,42,347,359,1,99999,7567,7279,6577,0.0966310993885625,0,0,NA,NA,none,hothiphop.parents,hot.parents
2019,1,WCR2019_1483,2,WCR2019_0223,WCR2019_0087,within-group subordinate,within-group subordinate,374,312,62,51,42,363,354,1,99999,6055,7279,5258,0.0966310993885625,0,0,NA,NA,none,hothiphop.parents,hot.parents
2019,1,WCR2019_1483,3,WCR2019_0219,WCR2019_0641,within-group subordinate,within-group subordinate,391,292,99,30,89,322,381,1,99999,7567,6160,5612,0.0966310993885625,0,0,NA,NA,none,hothiphop.parents,hot.parents
2019,1,WCR2019_1484,1,WCR2019_0223,WCR2019_0641,within-group subordinate,within-group subordinate,272,222,50,53,31,275,253,1,99999,6032,6129,4530,0.139865190178142,0,0,NA,NA,none,hothiphop.parents,hot.parents
2019,1,WCR2019_1484,2,WCR2019_0223,WCR2019_0327,within-group subordinate,within-group subordinate,307,252,55,53,12,305,264,1,99999,6032,8161,5948,0.139865190178142,0,0,NA,NA,none,hothiphop.parents,hot.parents
2019,1,WCR2019_1484,3,WCR2019_0440,WCR2019_0641,within-group subordinate,within-group subordinate,311,256,55,48,31,304,287,1,99999,6905,6129,5138,0.139865190178142,0,0,NA,NA,none,hothiphop.parents,hot.parents
2019,1,WCR2019_1485,1,WCR2019_0223,WCR2019_0641,within-group subordinate,within-group subordinate,237,212,25,24,12,236,224,1,99999,6075,6176,4563,0.165491695543076,0,0,NA,NA,none,hothiphop.parents,hot.parents
2019,1,WCR2019_1485,2,WCR2019_0008,WCR2019_0641,within-group subordinate,within-group subordinate,268,253,15,10,12,263,265,1,99999,8232,6176,6089,0.165491695543076,0,0,NA,NA,none,hothiphop.parents,hot.parents
2019,1,WCR2019_1485,3,WCR2019_0223,WCR2019_0122,within-group subordinate,within-group subordinate,273,246,27,24,6,270,252,1,99999,6075,8303,6025,0.165491695543076,0,0,NA,NA,none,hothiphop.parents,hot.parents
2019,1,WCR2019_1486,1,WCR2019_0223,WCR2019_0641,within-group subordinate,within-group subordinate,312,257,55,39,58,296,315,1,99999,6063,6164,4554,0.141642720306513,0,0,NA,NA,none,hothiphop.parents,hot.parents
2019,1,WCR2019_1486,2,WCR2019_0223,WCR2019_0122,within-group subordinate,within-group subordinate,348,302,46,39,32,341,334,1,99999,6063,8287,6014,0.141642720306513,0,0,NA,NA,none,hothiphop.parents,hot.parents
2019,1,WCR2019_1486,3,WCR2019_0440,WCR2019_0641,within-group subordinate,within-group subordinate,348,288,60,41,58,329,346,1,99999,6942,6164,5167,0.141642720306513,0,0,NA,NA,none,hothiphop.parents,hot.parents
2019,1,WCR2019_1487,1,WCR2019_0223,WCR2019_0641,within-group subordinate,within-group subordinate,325,249,76,45,81,294,330,1,99999,6036,6137,4534,0.0990503666306046,0,0,NA,NA,none,hothiphop.parents,hot.parents
2019,1,WCR2019_1487,2,WCR2019_0223,WCR2019_0452,within-group subordinate,within-group subordinate,352,278,74,45,55,323,333,1,99999,6036,8275,6004,0.0990503666306046,0,0,NA,NA,none,hothiphop.parents,hot.parents
2019,1,WCR2019_1487,3,WCR2019_0223,WCR2019_0327,within-group subordinate,within-group subordinate,354,301,53,45,36,346,337,1,99999,6036,8168,5950,0.0990503666306046,0,0,NA,NA,none,hothiphop.parents,hot.parents
2019,1,WCR2019_1488,1,WCR2019_0223,WCR2019_0641,within-group subordinate,within-group subordinate,352,264,88,54,106,318,370,1,99999,6034,6144,4533,0.0899807784718885,0,0,NA,NA,none,hothiphop.parents,hot.parents
2019,1,WCR2019_1488,2,WCR2019_0223,WCR2019_0087,within-group subordinate,within-group subordinate,362,296,66,54,62,350,358,1,99999,6034,7271,5247,0.0899807784718885,0,0,NA,NA,none,hothiphop.parents,hot.parents
2019,1,WCR2019_1488,3,WCR2019_0223,WCR2019_0327,within-group subordinate,within-group subordinate,370,308,62,54,41,362,349,1,99999,6034,8175,5950,0.0899807784718885,0,0,NA,NA,none,hothiphop.parents,hot.parents
2019,1,WCR2019_1490,1,WCR2019_0223,WCR2019_0641,within-group subordinate,within-group subordinate,167,150,17,13,10,163,160,1,99999,5991,6098,4503,0.169512047463373,0,0,NA,NA,none,hothiphop.parents,hot.parents
2019,1,WCR2019_1490,2,WCR2019_0223,WCR2019_0088,within-group subordinate,within-group subordinate,181,169,12,13,3,182,172,1,99999,5991,7312,5289,0.169512047463373,0,0,NA,NA,none,hothiphop.parents,hot.parents
2019,1,WCR2019_1490,3,WCR2019_0223,WCR2019_0122,within-group subordinate,within-group subordinate,189,175,14,13,2,188,177,1,99999,5991,8194,5941,0.169512047463373,0,0,NA,NA,none,hothiphop.parents,hot.parents
2019,1,WCR2019_1492,1,WCR2019_0223,WCR2019_0641,within-group subordinate,within-group subordinate,254,239,15,17,9,256,248,1,99999,5982,6078,4490,0.187742718446602,0,0,NA,NA,none,hothiphop.parents,hot.parents
2019,1,WCR2019_1492,2,WCR2019_0223,WCR2019_0075,within-group subordinate,within-group subordinate,268,251,17,17,6,268,257,1,99999,5982,7710,5563,0.187742718446602,0,0,NA,NA,none,hothiphop.parents,hot.parents
2019,1,WCR2019_1492,3,WCR2019_0223,WCR2019_0088,within-group subordinate,within-group subordinate,275,260,15,17,6,277,266,1,99999,5982,7298,5281,0.187742718446602,0,0,NA,NA,none,hothiphop.parents,hot.parents
2019,1,WCR2019_1500,1,WCR2019_0223,WCR2019_0641,within-group subordinate,within-group subordinate,223,189,34,31,14,220,203,1,99999,6073,6170,4560,0.175218275325918,0,0,NA,NA,none,hothiphop.parents,hot.parents
2019,1,WCR2019_1500,2,WCR2019_0223,WCR2019_0088,within-group subordinate,within-group subordinate,236,210,26,31,5,241,215,1,99999,6073,7386,5350,0.175218275325918,0,0,NA,NA,none,hothiphop.parents,hot.parents
2019,1,WCR2019_1500,3,WCR2019_0223,WCR2019_0327,within-group subordinate,within-group subordinate,248,212,36,31,8,243,220,1,99999,6073,8211,5988,0.175218275325918,0,0,NA,NA,none,hothiphop.parents,hot.parents
2019,1,WCR2019_1501,1,WCR2019_0223,WCR2019_0641,within-group subordinate,within-group subordinate,293,244,49,30,62,274,306,1,99999,6068,6174,4558,0.127435744172146,0,0,NA,NA,none,hothiphop.parents,hot.parents
2019,1,WCR2019_1501,2,WCR2019_0223,WCR2019_0075,within-group subordinate,within-group subordinate,325,278,47,30,49,308,327,1,99999,6068,7818,5635,0.127435744172146,0,0,NA,NA,none,hothiphop.parents,hot.parents
2019,1,WCR2019_1501,3,WCR2019_0482,WCR2019_0641,within-group subordinate,within-group subordinate,333,258,75,23,62,281,320,1,99999,8260,6174,6103,0.127435744172146,0,0,NA,NA,none,hothiphop.parents,hot.parents
2019,1,WCR2019_1502,1,WCR2019_0260,WCR2019_0405,within-group subordinate,within-group subordinate,61,48,13,17,0,65,48,1,99999,8244,8164,8082,0.0234121743306519,0,0,NA,NA,none,hothiphop.parents,hot.parents
2019,1,WCR2019_1502,2,WCR2019_0474,WCR2019_0405,within-group subordinate,within-group subordinate,63,49,14,15,0,64,49,1,99999,7992,8164,7845,0.0234121743306519,0,0,NA,NA,none,hothiphop.parents,hot.parents
2019,1,WCR2019_1502,3,WCR2019_0064,WCR2019_0405,within-group subordinate,within-group subordinate,68,52,16,16,0,68,52,1,99999,7266,8164,7145,0.0234121743306519,0,0,NA,NA,none,hothiphop.parents,hot.parents
2019,1,WCR2019_1504,1,WCR2019_0361,WCR2019_0641,within-group subordinate,within-group subordinate,200,163,37,3,36,166,199,1,99999,7975,6175,5918,0.138124850514231,0,0,NA,NA,none,hothiphop.parents,hot.parents
2019,1,WCR2019_1504,2,WCR2019_0361,WCR2019_0327,within-group subordinate,within-group subordinate,208,195,13,3,12,198,207,1,99999,7975,8212,7846,0.138124850514231,0,0,NA,NA,none,hothiphop.parents,hot.parents
2019,1,WCR2019_1504,3,WCR2019_0361,WCR2019_0122,within-group subordinate,within-group subordinate,221,205,16,3,14,208,219,1,99999,7975,8296,7912,0.138124850514231,0,0,NA,NA,none,hothiphop.parents,hot.parents
2019,1,WCR2019_1506,1,WCR2019_0441,WCR2019_0405,within-group subordinate,within-group subordinate,58,50,8,10,0,60,50,1,99999,8259,8119,8096,0.0229413185220961,0,0,NA,NA,none,hothiphop.parents,hot.parents
2019,1,WCR2019_1506,2,WCR2019_0474,WCR2019_0405,within-group subordinate,within-group subordinate,60,46,14,16,0,62,46,1,99999,7951,8119,7805,0.0229413185220961,0,0,NA,NA,none,hothiphop.parents,hot.parents
2019,1,WCR2019_1506,3,WCR2019_0252,WCR2019_0405,within-group subordinate,within-group subordinate,61,47,14,15,0,62,47,1,99999,8232,8119,8070,0.0229413185220961,0,0,NA,NA,none,hothiphop.parents,hot.parents
2019,1,WCR2019_1507,1,WCR2019_0474,WCR2019_0516,within-group subordinate,within-group subordinate,76,60,16,11,6,71,66,1,99999,8016,8305,7967,0.166487133453022,0,0,NA,NA,none,hothiphop.parents,hot.parents
2019,1,WCR2019_1507,2,WCR2019_0505,WCR2019_0516,within-group subordinate,within-group subordinate,83,54,29,24,6,78,60,1,99999,8294,8305,8245,0.166487133453022,0,0,NA,NA,none,hothiphop.parents,hot.parents
2019,1,WCR2019_1507,3,WCR2019_0345,WCR2019_0516,within-group subordinate,within-group subordinate,88,76,12,9,6,85,82,1,99999,8287,8305,8237,0.166487133453022,0,0,NA,NA,none,hothiphop.parents,hot.parents
2019,1,WCR2019_1508,1,WCR2019_0474,WCR2019_0405,within-group subordinate,within-group subordinate,54,41,13,14,0,55,41,1,99999,7987,8158,7838,0.0255886592984142,0,0,NA,NA,none,hothiphop.parents,hot.parents
2019,1,WCR2019_1508,2,WCR2019_0256,WCR2019_0405,within-group subordinate,within-group subordinate,67,46,21,22,0,68,46,1,99999,8261,8158,8096,0.0255886592984142,0,0,NA,NA,none,hothiphop.parents,hot.parents
2019,1,WCR2019_1508,3,WCR2019_0260,WCR2019_0405,within-group subordinate,within-group subordinate,68,51,17,19,0,70,51,1,99999,8239,8158,8077,0.0255886592984142,0,0,NA,NA,none,hothiphop.parents,hot.parents
2019,1,WCR2019_1509,1,WCR2019_0409,WCR2019_0634,within-group subordinate,within-group subordinate,104,67,37,25,22,92,89,1,99999,8327,8320,8289,0.0253618853929896,0,0,NA,NA,none,hothiphop.parents,hot.parents
2019,1,WCR2019_1509,2,WCR2019_0064,WCR2019_0088,within-group subordinate,within-group subordinate,105,75,30,21,25,96,100,1,99999,7285,7385,6660,0.0253618853929896,0,0,NA,NA,none,hothiphop.parents,hot.parents
2019,1,WCR2019_1509,3,WCR2019_0474,WCR2019_0388,within-group subordinate,within-group subordinate,105,73,32,15,25,88,98,1,99999,8019,8336,7996,0.0253618853929896,0,0,NA,NA,none,hothiphop.parents,hot.parents
2019,1,WCR2019_1510,1,WCR2019_0223,WCR2019_0641,within-group subordinate,within-group subordinate,333,266,67,41,70,307,336,1,99999,5994,6097,4505,0.105632949727438,0,0,NA,NA,none,hothiphop.parents,hot.parents
2019,1,WCR2019_1510,2,WCR2019_0223,WCR2019_0087,within-group subordinate,within-group subordinate,366,306,60,41,48,347,354,1,99999,5994,7199,5203,0.105632949727438,0,0,NA,NA,none,hothiphop.parents,hot.parents
2019,1,WCR2019_1510,3,WCR2019_0223,WCR2019_0075,within-group subordinate,within-group subordinate,381,317,64,41,61,358,378,1,99999,5994,7715,5566,0.105632949727438,0,0,NA,NA,none,hothiphop.parents,hot.parents
2019,1,WCR2019_1512,1,WCR2019_0536,WCR2019_0463,within-group subordinate,within-group subordinate,17,5,12,6,6,11,11,1,99999,8265,8337,8249,0.123069555848198,0,0,NA,NA,none,hothiphop.parents,hot.parents
2019,1,WCR2019_1512,2,WCR2019_0536,WCR2019_0039,within-group subordinate,within-group subordinate,180,138,42,6,37,144,175,1,99999,8265,8228,8142,0.123069555848198,0,0,NA,NA,none,hothiphop.parents,hot.parents
2019,1,WCR2019_1512,3,WCR2019_0536,WCR2019_0122,within-group subordinate,within-group subordinate,196,164,32,6,28,170,192,1,99999,8265,8288,8201,0.123069555848198,0,0,NA,NA,none,hothiphop.parents,hot.parents
2019,1,WCR2019_1513,1,WCR2019_0223,WCR2019_0641,within-group subordinate,within-group subordinate,429,392,37,26,32,418,424,1,99999,6020,6115,4522,0.189763399323998,0,0,NA,NA,none,hothiphop.parents,hot.parents
2019,1,WCR2019_1513,2,WCR2019_0126,WCR2019_0641,within-group subordinate,within-group subordinate,467,379,88,93,32,472,411,1,99999,5255,6115,3924,0.189763399323998,0,0,NA,NA,none,hothiphop.parents,hot.parents
2019,1,WCR2019_1513,3,WCR2019_0223,WCR2019_0327,within-group subordinate,within-group subordinate,512,484,28,26,12,510,496,1,99999,6020,8136,5935,0.189763399323998,0,0,NA,NA,none,hothiphop.parents,hot.parents
2019,1,WCR2019_1514,1,WCR2019_0223,WCR2019_0641,within-group subordinate,within-group subordinate,341,260,81,51,83,311,343,1,99999,6059,6160,4552,0.105584851390221,0,0,NA,NA,none,hothiphop.parents,hot.parents
2019,1,WCR2019_1514,2,WCR2019_0223,WCR2019_0161,within-group subordinate,within-group subordinate,342,284,58,51,20,335,304,1,99999,6059,8210,5964,0.105584851390221,0,0,NA,NA,none,hothiphop.parents,hot.parents
2019,1,WCR2019_1514,3,WCR2019_0440,WCR2019_0161,within-group subordinate,within-group subordinate,354,297,57,48,20,345,317,1,99999,6939,8210,6830,0.105584851390221,0,0,NA,NA,none,hothiphop.parents,hot.parents
2019,1,WCR2019_1515,1,WCR2019_0223,WCR2019_0087,within-group subordinate,within-group subordinate,341,271,70,62,64,333,335,1,99999,6068,7297,5270,0.0942696494796028,0,0,NA,NA,none,hothiphop.parents,hot.parents
2019,1,WCR2019_1515,2,WCR2019_0223,WCR2019_0641,within-group subordinate,within-group subordinate,349,259,90,62,104,321,363,1,99999,6068,6172,4559,0.0942696494796028,0,0,NA,NA,none,hothiphop.parents,hot.parents
2019,1,WCR2019_1515,3,WCR2019_0223,WCR2019_0327,within-group subordinate,within-group subordinate,378,308,70,62,53,370,361,1,99999,6068,8208,5982,0.0942696494796028,0,0,NA,NA,none,hothiphop.parents,hot.parents
2019,1,WCR2019_1518,1,WCR2019_0534,WCR2019_0066,within-group subordinate,within-group subordinate,99,79,20,15,6,94,85,1,99999,8304,8287,8258,0.1261250450018,0,0,NA,NA,none,hothiphop.parents,hot.parents
2019,1,WCR2019_1518,2,WCR2019_0011,WCR2019_0066,within-group subordinate,within-group subordinate,187,154,33,29,6,183,160,1,99999,8319,8287,8273,0.1261250450018,0,0,NA,NA,none,hothiphop.parents,hot.parents
2019,1,WCR2019_1518,3,WCR2019_0008,WCR2019_0066,within-group subordinate,within-group subordinate,190,159,31,26,6,185,165,1,99999,8197,8287,8152,0.1261250450018,0,0,NA,NA,none,hothiphop.parents,hot.parents
2019,1,WCR2019_1519,1,WCR2019_0223,WCR2019_0641,within-group subordinate,within-group subordinate,320,268,52,36,67,304,335,1,99999,6063,6167,4553,0.126735280038296,0,0,NA,NA,none,hothiphop.parents,hot.parents
2019,1,WCR2019_1519,2,WCR2019_0223,WCR2019_0537,within-group subordinate,within-group subordinate,339,290,49,36,37,326,327,1,99999,6063,8338,6052,0.126735280038296,0,0,NA,NA,none,hothiphop.parents,hot.parents
2019,1,WCR2019_1519,3,WCR2019_0223,WCR2019_0122,within-group subordinate,within-group subordinate,342,304,38,36,22,340,326,1,99999,6063,8290,6013,0.126735280038296,0,0,NA,NA,none,hothiphop.parents,hot.parents
2019,1,WCR2019_1523,1,WCR2019_0474,WCR2019_0405,within-group subordinate,within-group subordinate,70,48,22,23,0,71,48,1,99999,8008,8181,7860,0.0220438480891338,0,0,NA,NA,none,hothiphop.parents,hot.parents
2019,1,WCR2019_1523,2,WCR2019_0260,WCR2019_0405,within-group subordinate,within-group subordinate,75,51,24,27,0,78,51,1,99999,8263,8181,8101,0.0220438480891338,0,0,NA,NA,none,hothiphop.parents,hot.parents
2019,1,WCR2019_1523,3,WCR2019_0559,WCR2019_0405,within-group subordinate,within-group subordinate,77,56,21,22,0,78,56,1,99999,8295,8181,8131,0.0220438480891338,0,0,NA,NA,none,hothiphop.parents,hot.parents
2019,1,WCR2019_1524,1,WCR2019_0223,WCR2019_0206,within-group subordinate,within-group subordinate,236,190,46,45,5,235,195,1,99999,6067,8283,6020,0.143062372800192,0,0,NA,NA,none,hothiphop.parents,hot.parents
2019,1,WCR2019_1524,2,WCR2019_0440,WCR2019_0206,within-group subordinate,within-group subordinate,265,221,44,39,5,260,226,1,99999,6945,8283,6903,0.143062372800192,0,0,NA,NA,none,hothiphop.parents,hot.parents
2019,1,WCR2019_1524,3,WCR2019_0076,WCR2019_0206,within-group subordinate,within-group subordinate,269,225,44,40,5,265,230,1,99999,7186,8283,7117,0.143062372800192,0,0,NA,NA,none,hothiphop.parents,hot.parents
2019,1,WCR2019_1525,1,WCR2019_0223,WCR2019_0516,within-group subordinate,within-group subordinate,245,192,53,51,3,243,195,1,99999,6037,8265,6007,0.0992182802164762,0,0,NA,NA,none,hothiphop.parents,hot.parents
2019,1,WCR2019_1525,2,WCR2019_0008,WCR2019_0516,within-group subordinate,within-group subordinate,252,218,34,32,3,250,221,1,99999,8178,8265,8129,0.0992182802164762,0,0,NA,NA,none,hothiphop.parents,hot.parents
2019,1,WCR2019_1525,3,WCR2019_0440,WCR2019_0516,within-group subordinate,within-group subordinate,254,208,46,44,3,252,211,1,99999,6918,8265,6878,0.0992182802164762,0,0,NA,NA,none,hothiphop.parents,hot.parents
2019,1,WCR2019_1526,1,WCR2019_0223,WCR2019_0641,within-group subordinate,within-group subordinate,258,209,49,47,31,256,240,1,99999,6045,6158,4549,0.146786786786787,0,0,NA,NA,none,hothiphop.parents,hot.parents
2019,1,WCR2019_1526,2,WCR2019_0008,WCR2019_0641,within-group subordinate,within-group subordinate,290,255,35,15,31,270,286,1,99999,8189,6158,6072,0.146786786786787,0,0,NA,NA,none,hothiphop.parents,hot.parents
2019,1,WCR2019_1526,3,WCR2019_0223,WCR2019_0075,within-group subordinate,within-group subordinate,298,243,55,47,27,290,270,1,99999,6045,7781,5614,0.146786786786787,0,0,NA,NA,none,hothiphop.parents,hot.parents
2019,1,WCR2019_1527,1,WCR2019_0507,WCR2019_0122,within-group subordinate,within-group subordinate,277,228,49,4,45,232,273,1,99999,8323,8283,8259,0.116209416556847,0,0,NA,NA,none,hothiphop.parents,hot.parents
2019,1,WCR2019_1527,2,WCR2019_0507,WCR2019_0327,within-group subordinate,within-group subordinate,286,250,36,4,32,254,282,1,99999,8323,8196,8173,0.116209416556847,0,0,NA,NA,none,hothiphop.parents,hot.parents
2019,1,WCR2019_1527,3,WCR2019_0507,WCR2019_0641,within-group subordinate,within-group subordinate,287,206,81,4,78,210,284,1,99999,8323,6162,6144,0.116209416556847,0,0,NA,NA,none,hothiphop.parents,hot.parents
2019,1,WCR2019_1531,1,WCR2019_0280,WCR2019_0286,within-group subordinate,within-group subordinate,6,5,1,0,2,5,7,1,99999,7936,7962,7884,0.0986899563318777,0,0,NA,NA,none,hothiphop.parents,hot.parents
2019,1,WCR2019_1531,2,WCR2019_0280,WCR2019_0327,within-group subordinate,within-group subordinate,118,108,10,0,10,108,118,1,99999,7936,7868,7796,0.0986899563318777,0,0,NA,NA,none,hothiphop.parents,hot.parents
2019,1,WCR2019_1531,3,WCR2019_0280,WCR2019_0417,within-group subordinate,within-group subordinate,126,115,11,0,11,115,126,1,99999,7936,7996,7920,0.0986899563318777,0,0,NA,NA,none,hothiphop.parents,hot.parents
2019,1,WCR2019_1532,1,WCR2019_0223,WCR2019_0641,within-group subordinate,within-group subordinate,355,273,82,59,94,332,367,1,99999,6058,6162,4548,0.0982880402250688,0,0,NA,NA,none,hothiphop.parents,hot.parents
2019,1,WCR2019_1532,2,WCR2019_0223,WCR2019_0087,within-group subordinate,within-group subordinate,392,321,71,59,64,380,385,1,99999,6058,7289,5260,0.0982880402250688,0,0,NA,NA,none,hothiphop.parents,hot.parents
2019,1,WCR2019_1532,3,WCR2019_0126,WCR2019_0641,within-group subordinate,within-group subordinate,393,253,140,145,94,398,347,1,99999,5297,6162,3952,0.0982880402250688,0,0,NA,NA,none,hothiphop.parents,hot.parents
2019,1,WCR2019_1534,1,WCR2019_0223,WCR2019_0516,within-group subordinate,within-group subordinate,223,170,53,51,4,221,174,1,99999,6048,8278,6018,0.0979944758016092,0,0,NA,NA,none,hothiphop.parents,hot.parents
2019,1,WCR2019_1534,2,WCR2019_0556,WCR2019_0516,within-group subordinate,within-group subordinate,252,206,46,43,4,249,210,1,99999,8259,8278,8213,0.0979944758016092,0,0,NA,NA,none,hothiphop.parents,hot.parents
2019,1,WCR2019_1534,3,WCR2019_0440,WCR2019_0516,within-group subordinate,within-group subordinate,258,205,53,51,4,256,209,1,99999,6925,8278,6884,0.0979944758016092,0,0,NA,NA,none,hothiphop.parents,hot.parents
2019,1,WCR2019_1535,1,WCR2019_0223,WCR2019_0047,within-group subordinate,within-group subordinate,258,207,51,47,5,254,212,1,99999,6062,8349,6053,0.140430622009569,0,0,NA,NA,none,hothiphop.parents,hot.parents
2019,1,WCR2019_1535,2,WCR2019_0008,WCR2019_0047,within-group subordinate,within-group subordinate,278,254,24,20,5,274,259,1,99999,8223,8349,8212,0.140430622009569,0,0,NA,NA,none,hothiphop.parents,hot.parents
2019,1,WCR2019_1535,3,WCR2019_0440,WCR2019_0047,within-group subordinate,within-group subordinate,286,243,43,39,5,282,248,1,99999,6949,8349,6939,0.140430622009569,0,0,NA,NA,none,hothiphop.parents,hot.parents
2019,1,WCR2019_1536,1,WCR2019_0223,WCR2019_0641,within-group subordinate,within-group subordinate,213,191,22,20,15,211,206,1,99999,6074,6181,4563,0.181058163143437,0,0,NA,NA,none,hothiphop.parents,hot.parents
2019,1,WCR2019_1536,2,WCR2019_0223,WCR2019_0075,within-group subordinate,within-group subordinate,249,228,21,20,12,248,240,1,99999,6074,7825,5640,0.181058163143437,0,0,NA,NA,none,hothiphop.parents,hot.parents
2019,1,WCR2019_1536,3,WCR2019_0223,WCR2019_0088,within-group subordinate,within-group subordinate,252,233,19,20,7,253,240,1,99999,6074,7401,5353,0.181058163143437,0,0,NA,NA,none,hothiphop.parents,hot.parents
2019,1,WCR2019_1538,1,WCR2019_0267,WCR2019_0641,within-group subordinate,within-group subordinate,261,197,64,4,63,201,260,1,99999,8234,6120,6083,0.123854317414375,0,0,NA,NA,none,hothiphop.parents,hot.parents
2019,1,WCR2019_1538,2,WCR2019_0267,WCR2019_0327,within-group subordinate,within-group subordinate,265,235,30,4,28,239,263,1,99999,8234,8145,8090,0.123854317414375,0,0,NA,NA,none,hothiphop.parents,hot.parents
2019,1,WCR2019_1538,3,WCR2019_0267,WCR2019_0109,within-group subordinate,within-group subordinate,268,222,46,4,44,226,266,1,99999,8234,8152,8096,0.123854317414375,0,0,NA,NA,none,hothiphop.parents,hot.parents
2019,1,WCR2019_1539,1,WCR2019_0223,WCR2019_0641,within-group subordinate,within-group subordinate,358,276,82,50,86,326,362,1,99999,6051,6147,4539,0.105806142034549,0,0,NA,NA,none,hothiphop.parents,hot.parents
2019,1,WCR2019_1539,2,WCR2019_0223,WCR2019_0087,within-group subordinate,within-group subordinate,382,319,63,50,59,369,378,1,99999,6051,7277,5257,0.105806142034549,0,0,NA,NA,none,hothiphop.parents,hot.parents
2019,1,WCR2019_1539,3,WCR2019_0126,WCR2019_0641,within-group subordinate,within-group subordinate,400,265,135,136,86,401,351,1,99999,5285,6147,3941,0.105806142034549,0,0,NA,NA,none,hothiphop.parents,hot.parents
2019,1,WCR2019_1540,1,WCR2019_0534,WCR2019_0519,within-group subordinate,within-group subordinate,110,97,13,10,3,107,100,1,99999,8335,8321,8291,0.112970711297071,0,0,NA,NA,none,hothiphop.parents,hot.parents
2019,1,WCR2019_1540,2,WCR2019_0011,WCR2019_0519,within-group subordinate,within-group subordinate,152,130,22,21,3,151,133,1,99999,8351,8321,8308,0.112970711297071,0,0,NA,NA,none,hothiphop.parents,hot.parents
2019,1,WCR2019_1540,3,WCR2019_0367,WCR2019_0519,within-group subordinate,within-group subordinate,154,134,20,20,3,154,137,1,99999,8313,8321,8269,0.112970711297071,0,0,NA,NA,none,hothiphop.parents,hot.parents
2019,1,WCR2019_1541,1,WCR2019_0223,WCR2019_0494,within-group subordinate,within-group subordinate,326,253,73,53,34,306,287,1,99999,6050,8292,6022,0.0918146903504561,0,0,NA,NA,none,hothiphop.parents,hot.parents
2019,1,WCR2019_1541,2,WCR2019_0223,WCR2019_0641,within-group subordinate,within-group subordinate,340,254,86,53,90,307,344,1,99999,6050,6153,4545,0.0918146903504561,0,0,NA,NA,none,hothiphop.parents,hot.parents
2019,1,WCR2019_1541,3,WCR2019_0223,WCR2019_0087,within-group subordinate,within-group subordinate,349,279,70,53,50,332,329,1,99999,6050,7276,5257,0.0918146903504561,0,0,NA,NA,none,hothiphop.parents,hot.parents
2019,1,WCR2019_1542,1,WCR2019_0223,WCR2019_0641,within-group subordinate,within-group subordinate,262,203,59,38,61,241,264,1,99999,5847,5936,4392,0.108212200273326,0,0,NA,NA,none,hothiphop.parents,hot.parents
2019,1,WCR2019_1542,2,WCR2019_0440,WCR2019_0641,within-group subordinate,within-group subordinate,301,239,62,29,61,268,300,1,99999,6689,5936,4974,0.108212200273326,0,0,NA,NA,none,hothiphop.parents,hot.parents
2019,1,WCR2019_1542,3,WCR2019_0223,WCR2019_0327,within-group subordinate,within-group subordinate,305,262,43,38,23,300,285,1,99999,5847,7906,5767,0.108212200273326,0,0,NA,NA,none,hothiphop.parents,hot.parents
2019,1,WCR2019_1545,1,WCR2019_0474,WCR2019_0405,within-group subordinate,within-group subordinate,57,46,11,11,1,57,47,1,99999,7931,8099,7784,0.0262584704743466,0,0,NA,NA,none,hothiphop.parents,hot.parents
2019,1,WCR2019_1545,2,WCR2019_0260,WCR2019_0405,within-group subordinate,within-group subordinate,63,50,13,14,1,64,51,1,99999,8178,8099,8017,0.0262584704743466,0,0,NA,NA,none,hothiphop.parents,hot.parents
2019,1,WCR2019_1545,3,WCR2019_0489,WCR2019_0405,within-group subordinate,within-group subordinate,64,49,15,15,1,64,50,1,99999,8230,8099,8065,0.0262584704743466,0,0,NA,NA,none,hothiphop.parents,hot.parents
2019,1,WCR2019_1546,1,WCR2019_0530,WCR2019_0405,within-group subordinate,within-group subordinate,8,3,5,4,1,7,4,1,99999,8236,8115,8075,0.0657322377960367,0,0,NA,NA,none,hothiphop.parents,hot.parents
2019,1,WCR2019_1546,2,WCR2019_0530,WCR2019_0122,within-group subordinate,within-group subordinate,64,48,16,4,12,52,60,1,99999,8236,8211,8171,0.0657322377960367,0,0,NA,NA,none,hothiphop.parents,hot.parents
2019,1,WCR2019_1546,3,WCR2019_0530,WCR2019_0388,within-group subordinate,within-group subordinate,65,44,21,4,17,48,61,1,99999,8236,8253,8214,0.0657322377960367,0,0,NA,NA,none,hothiphop.parents,hot.parents
2019,1,WCR2019_1547,1,WCR2019_0208,WCR2019_0327,within-group subordinate,within-group subordinate,357,307,50,33,23,340,330,1,99999,8243,8182,8097,0.114858377340374,0,0,NA,NA,none,hothiphop.parents,hot.parents
2019,1,WCR2019_1547,2,WCR2019_0223,WCR2019_0641,within-group subordinate,within-group subordinate,363,293,70,39,76,332,369,1,99999,6049,6147,4540,0.114858377340374,0,0,NA,NA,none,hothiphop.parents,hot.parents
2019,1,WCR2019_1547,3,WCR2019_0208,WCR2019_0641,within-group subordinate,within-group subordinate,372,283,89,33,76,316,359,1,99999,8243,6147,6088,0.114858377340374,0,0,NA,NA,none,hothiphop.parents,hot.parents
2019,1,WCR2019_1549,1,WCR2019_0223,WCR2019_0641,within-group subordinate,within-group subordinate,250,189,61,56,55,245,244,1,99999,6011,6104,4506,0.118783196523419,0,0,NA,NA,none,hothiphop.parents,hot.parents
2019,1,WCR2019_1549,2,WCR2019_0223,WCR2019_0327,within-group subordinate,within-group subordinate,280,223,57,56,10,279,233,1,99999,6011,8138,5926,0.118783196523419,0,0,NA,NA,none,hothiphop.parents,hot.parents
2019,1,WCR2019_1549,3,WCR2019_0223,WCR2019_0122,within-group subordinate,within-group subordinate,288,223,65,56,22,279,245,1,99999,6011,8221,5964,0.118783196523419,0,0,NA,NA,none,hothiphop.parents,hot.parents
2019,1,WCR2019_1550,1,WCR2019_0223,WCR2019_0641,within-group subordinate,within-group subordinate,250,201,49,37,50,238,251,1,99999,5973,6067,4479,0.139786252125334,0,0,NA,NA,none,hothiphop.parents,hot.parents
2019,1,WCR2019_1550,2,WCR2019_0223,WCR2019_0075,within-group subordinate,within-group subordinate,296,248,48,37,43,285,291,1,99999,5973,7699,5549,0.139786252125334,0,0,NA,NA,none,hothiphop.parents,hot.parents
2019,1,WCR2019_1550,3,WCR2019_0223,WCR2019_0327,within-group subordinate,within-group subordinate,298,256,42,37,17,293,273,1,99999,5973,8086,5889,0.139786252125334,0,0,NA,NA,none,hothiphop.parents,hot.parents
2019,1,WCR2019_1551,1,WCR2019_0474,WCR2019_0258,within-group subordinate,within-group subordinate,64,51,13,13,4,64,55,1,99999,8001,8258,7927,0.109285028790787,0,0,NA,NA,none,hothiphop.parents,hot.parents
2019,1,WCR2019_1551,2,WCR2019_0531,WCR2019_0258,within-group subordinate,within-group subordinate,71,58,13,14,4,72,62,1,99999,8308,8258,8230,0.109285028790787,0,0,NA,NA,none,hothiphop.parents,hot.parents
2019,1,WCR2019_1551,3,WCR2019_0409,WCR2019_0258,within-group subordinate,within-group subordinate,72,59,13,12,4,71,63,1,99999,8304,8258,8227,0.109285028790787,0,0,NA,NA,none,hothiphop.parents,hot.parents
2019,1,WCR2019_1552,1,WCR2019_0223,WCR2019_0641,within-group subordinate,within-group subordinate,335,254,81,53,91,307,345,1,99999,6040,6132,4532,0.111351611351611,0,0,NA,NA,none,hothiphop.parents,hot.parents
2019,1,WCR2019_1552,2,WCR2019_0223,WCR2019_0327,within-group subordinate,within-group subordinate,353,293,60,53,34,346,327,1,99999,6040,8168,5956,0.111351611351611,0,0,NA,NA,none,hothiphop.parents,hot.parents
2019,1,WCR2019_1552,3,WCR2019_0223,WCR2019_0122,within-group subordinate,within-group subordinate,363,295,68,53,49,348,344,1,99999,6040,8250,5990,0.111351611351611,0,0,NA,NA,none,hothiphop.parents,hot.parents
2019,1,WCR2019_1553,1,WCR2019_0583,WCR2019_0327,within-group subordinate,within-group subordinate,275,220,55,40,19,260,239,1,99999,8259,8134,8112,0.129059519497767,0,0,NA,NA,none,hothiphop.parents,hot.parents
2019,1,WCR2019_1553,2,WCR2019_0223,WCR2019_0641,within-group subordinate,within-group subordinate,275,199,76,48,70,247,269,1,99999,6009,6118,4518,0.129059519497767,0,0,NA,NA,none,hothiphop.parents,hot.parents
2019,1,WCR2019_1553,3,WCR2019_0380,WCR2019_0327,within-group subordinate,within-group subordinate,281,228,53,37,19,265,247,1,99999,8228,8134,8082,0.129059519497767,0,0,NA,NA,none,hothiphop.parents,hot.parents
2019,1,WCR2019_1555,1,WCR2019_0223,WCR2019_0641,within-group subordinate,within-group subordinate,360,289,71,41,79,330,368,1,99999,6008,6110,4509,0.100857591496558,0,0,NA,NA,none,hothiphop.parents,hot.parents
2019,1,WCR2019_1555,2,WCR2019_0223,WCR2019_0087,within-group subordinate,within-group subordinate,373,318,55,41,43,359,361,1,99999,6008,7237,5225,0.100857591496558,0,0,NA,NA,none,hothiphop.parents,hot.parents
2019,1,WCR2019_1555,3,WCR2019_0223,WCR2019_0327,within-group subordinate,within-group subordinate,387,339,48,41,24,380,363,1,99999,6008,8131,5925,0.100857591496558,0,0,NA,NA,none,hothiphop.parents,hot.parents
2019,1,WCR2019_1557,1,WCR2019_0223,WCR2019_0641,within-group subordinate,within-group subordinate,350,259,91,69,74,328,333,1,99999,6052,6153,4540,0.11256293454807,0,0,NA,NA,none,hothiphop.parents,hot.parents
2019,1,WCR2019_1557,2,WCR2019_0223,WCR2019_0327,within-group subordinate,within-group subordinate,371,297,74,69,32,366,329,1,99999,6052,8191,5966,0.11256293454807,0,0,NA,NA,none,hothiphop.parents,hot.parents
2019,1,WCR2019_1557,3,WCR2019_0126,WCR2019_0641,within-group subordinate,within-group subordinate,371,229,142,159,74,388,303,1,99999,5296,6153,3950,0.11256293454807,0,0,NA,NA,none,hothiphop.parents,hot.parents
2019,1,WCR2019_1558,1,WCR2019_0369,WCR2019_0327,within-group subordinate,within-group subordinate,229,213,16,2,14,215,227,1,99999,8240,8108,8090,0.113344635504965,0,0,NA,NA,none,hothiphop.parents,hot.parents
2019,1,WCR2019_1558,2,WCR2019_0369,WCR2019_0641,within-group subordinate,within-group subordinate,230,177,53,2,52,179,229,1,99999,8240,6090,6078,0.113344635504965,0,0,NA,NA,none,hothiphop.parents,hot.parents
2019,1,WCR2019_1558,3,WCR2019_0369,WCR2019_0122,within-group subordinate,within-group subordinate,233,211,22,2,21,213,232,1,99999,8240,8193,8175,0.113344635504965,0,0,NA,NA,none,hothiphop.parents,hot.parents
2019,1,WCR2019_1560,1,WCR2019_0474,WCR2019_0405,within-group subordinate,within-group subordinate,52,43,9,10,1,53,44,1,99999,7824,7991,7683,0.0240549828178694,0,0,NA,NA,none,hothiphop.parents,hot.parents
2019,1,WCR2019_1560,2,WCR2019_0196,WCR2019_0405,within-group subordinate,within-group subordinate,57,47,10,11,1,58,48,1,99999,8091,7991,7935,0.0240549828178694,0,0,NA,NA,none,hothiphop.parents,hot.parents
2019,1,WCR2019_1560,3,WCR2019_0409,WCR2019_0405,within-group subordinate,within-group subordinate,57,43,14,16,1,59,44,1,99999,8118,7991,7963,0.0240549828178694,0,0,NA,NA,none,hothiphop.parents,hot.parents
2019,1,WCR2019_1562,1,WCR2019_0344,WCR2019_0313,within-group subordinate,within-group subordinate,29,14,15,3,12,17,26,1,99999,8248,8223,8199,0.11398525323341,0,0,NA,NA,none,hothiphop.parents,hot.parents
2019,1,WCR2019_1562,2,WCR2019_0344,WCR2019_0327,within-group subordinate,within-group subordinate,197,184,13,3,11,187,195,1,99999,8248,8124,8101,0.11398525323341,0,0,NA,NA,none,hothiphop.parents,hot.parents
2019,1,WCR2019_1562,3,WCR2019_0361,WCR2019_0313,within-group subordinate,within-group subordinate,203,173,30,20,12,193,185,1,99999,7888,8223,7845,0.11398525323341,0,0,NA,NA,none,hothiphop.parents,hot.parents
2019,1,WCR2019_1564,1,WCR2019_0223,WCR2019_0285,within-group subordinate,within-group subordinate,233,188,45,37,9,225,197,1,99999,5933,8152,5915,0.128236443575965,0,0,NA,NA,none,hothiphop.parents,hot.parents
2019,1,WCR2019_1564,2,WCR2019_0076,WCR2019_0285,within-group subordinate,within-group subordinate,254,215,39,35,9,250,224,1,99999,7061,8152,7027,0.128236443575965,0,0,NA,NA,none,hothiphop.parents,hot.parents
2019,1,WCR2019_1564,3,WCR2019_0219,WCR2019_0285,within-group subordinate,within-group subordinate,254,204,50,44,9,248,213,1,99999,7421,8152,7394,0.128236443575965,0,0,NA,NA,none,hothiphop.parents,hot.parents
2019,1,WCR2019_1565,1,WCR2019_0474,WCR2019_0537,within-group subordinate,within-group subordinate,64,47,17,15,2,62,49,1,99999,7894,8207,7879,0.117732911700316,0,0,NA,NA,none,hothiphop.parents,hot.parents
2019,1,WCR2019_1565,2,WCR2019_0263,WCR2019_0537,within-group subordinate,within-group subordinate,65,54,11,9,2,63,56,1,99999,8169,8207,8154,0.117732911700316,0,0,NA,NA,none,hothiphop.parents,hot.parents
2019,1,WCR2019_1565,3,WCR2019_0260,WCR2019_0537,within-group subordinate,within-group subordinate,65,50,15,15,2,65,52,1,99999,8136,8207,8121,0.117732911700316,0,0,NA,NA,none,hothiphop.parents,hot.parents
2019,1,WCR2019_1566,1,WCR2019_0474,WCR2019_0405,within-group subordinate,within-group subordinate,63,49,14,12,2,61,51,1,99999,7538,7687,7413,0.0242842535787321,0,0,NA,NA,none,hothiphop.parents,hot.parents
2019,1,WCR2019_1566,2,WCR2019_0441,WCR2019_0405,within-group subordinate,within-group subordinate,68,55,13,11,2,66,57,1,99999,7803,7687,7666,0.0242842535787321,0,0,NA,NA,none,hothiphop.parents,hot.parents
2019,1,WCR2019_1566,3,WCR2019_0324,WCR2019_0405,within-group subordinate,within-group subordinate,68,52,16,16,2,68,54,1,99999,7812,7687,7675,0.0242842535787321,0,0,NA,NA,none,hothiphop.parents,hot.parents
2019,1,WCR2019_1567,1,WCR2019_0223,WCR2019_0087,within-group subordinate,within-group subordinate,342,275,67,55,53,330,328,1,99999,6042,7279,5252,0.0962323014158867,0,0,NA,NA,none,hothiphop.parents,hot.parents
2019,1,WCR2019_1567,2,WCR2019_0223,WCR2019_0641,within-group subordinate,within-group subordinate,352,267,85,55,92,322,359,1,99999,6042,6148,4539,0.0962323014158867,0,0,NA,NA,none,hothiphop.parents,hot.parents
2019,1,WCR2019_1567,3,WCR2019_0126,WCR2019_0641,within-group subordinate,within-group subordinate,388,257,131,132,92,389,349,1,99999,5291,6148,3948,0.0962323014158867,0,0,NA,NA,none,hothiphop.parents,hot.parents
2019,1,WCR2019_1568,1,WCR2019_0547,WCR2019_0047,within-group subordinate,within-group subordinate,50,39,11,7,4,46,43,1,99999,8039,8071,8030,0.109653465346535,0,0,NA,NA,none,hothiphop.parents,hot.parents
2019,1,WCR2019_1568,2,WCR2019_0011,WCR2019_0047,within-group subordinate,within-group subordinate,52,41,11,7,4,48,45,1,99999,8066,8071,8058,0.109653465346535,0,0,NA,NA,none,hothiphop.parents,hot.parents
2019,1,WCR2019_1568,3,WCR2019_0595,WCR2019_0047,within-group subordinate,within-group subordinate,56,47,9,6,4,53,51,1,99999,8066,8071,8057,0.109653465346535,0,0,NA,NA,none,hothiphop.parents,hot.parents
2019,1,WCR2019_1569,1,WCR2019_0214,WCR2019_0327,within-group subordinate,within-group subordinate,206,190,16,1,15,191,205,1,99999,8264,8162,8116,0.106700348851197,0,0,NA,NA,none,hothiphop.parents,hot.parents
2019,1,WCR2019_1569,2,WCR2019_0214,WCR2019_0161,within-group subordinate,within-group subordinate,228,196,32,1,31,197,227,1,99999,8264,8181,8132,0.106700348851197,0,0,NA,NA,none,hothiphop.parents,hot.parents
2019,1,WCR2019_1569,3,WCR2019_0214,WCR2019_0122,within-group subordinate,within-group subordinate,229,189,40,1,39,190,228,1,99999,8264,8248,8200,0.106700348851197,0,0,NA,NA,none,hothiphop.parents,hot.parents
2019,1,WCR2019_1570,1,WCR2019_0536,WCR2019_0463,within-group subordinate,within-group subordinate,21,12,9,4,5,16,17,1,99999,8204,8277,8188,0.123598215362354,0,0,NA,NA,none,hothiphop.parents,hot.parents
2019,1,WCR2019_1570,2,WCR2019_0536,WCR2019_0039,within-group subordinate,within-group subordinate,213,176,37,4,34,180,210,1,99999,8204,8168,8081,0.123598215362354,0,0,NA,NA,none,hothiphop.parents,hot.parents
2019,1,WCR2019_1570,3,WCR2019_0536,WCR2019_0122,within-group subordinate,within-group subordinate,219,187,32,4,29,191,216,1,99999,8204,8229,8141,0.123598215362354,0,0,NA,NA,none,hothiphop.parents,hot.parents
2019,1,WCR2019_1571,1,WCR2019_0223,WCR2019_0243,within-group subordinate,within-group subordinate,245,191,54,52,4,243,195,1,99999,5996,8189,5955,0.091800896209277,0,0,NA,NA,none,hothiphop.parents,hot.parents
2019,1,WCR2019_1571,2,WCR2019_0440,WCR2019_0243,within-group subordinate,within-group subordinate,284,223,61,58,4,281,227,1,99999,6866,8189,6815,0.091800896209277,0,0,NA,NA,none,hothiphop.parents,hot.parents
2019,1,WCR2019_1571,3,WCR2019_0076,WCR2019_0243,within-group subordinate,within-group subordinate,286,243,43,44,4,287,247,1,99999,7111,8189,7047,0.091800896209277,0,0,NA,NA,none,hothiphop.parents,hot.parents
2019,1,WCR2019_1573,1,WCR2019_0223,WCR2019_0641,within-group subordinate,within-group subordinate,245,205,40,24,48,229,253,1,99999,5877,5974,4410,0.12686843730698,0,0,NA,NA,none,hothiphop.parents,hot.parents
2019,1,WCR2019_1573,2,WCR2019_0223,WCR2019_0327,within-group subordinate,within-group subordinate,273,245,28,24,11,269,256,1,99999,5877,7949,5795,0.12686843730698,0,0,NA,NA,none,hothiphop.parents,hot.parents
2019,1,WCR2019_1573,3,WCR2019_0223,WCR2019_0161,within-group subordinate,within-group subordinate,282,251,31,24,18,275,269,1,99999,5877,7966,5786,0.12686843730698,0,0,NA,NA,none,hothiphop.parents,hot.parents
2019,1,WCR2019_1574,1,WCR2019_0262,WCR2019_0327,within-group subordinate,within-group subordinate,253,235,18,8,15,243,250,1,99999,8148,8038,8003,0.132054727583679,0,0,NA,NA,none,hothiphop.parents,hot.parents
2019,1,WCR2019_1574,2,WCR2019_0262,WCR2019_0537,within-group subordinate,within-group subordinate,258,227,31,8,27,235,254,1,99999,8148,8169,8131,0.132054727583679,0,0,NA,NA,none,hothiphop.parents,hot.parents
2019,1,WCR2019_1574,3,WCR2019_0223,WCR2019_0641,within-group subordinate,within-group subordinate,258,214,44,41,41,255,255,1,99999,5956,6040,4472,0.132054727583679,0,0,NA,NA,none,hothiphop.parents,hot.parents
2019,1,WCR2019_1575,1,WCR2019_0223,WCR2019_0323,within-group subordinate,within-group subordinate,265,196,69,63,19,259,215,1,99999,6049,8322,6035,0.127787101414529,0,0,NA,NA,none,hothiphop.parents,hot.parents
2019,1,WCR2019_1575,2,WCR2019_0440,WCR2019_0323,within-group subordinate,within-group subordinate,266,217,49,41,19,258,236,1,99999,6936,8322,6922,0.127787101414529,0,0,NA,NA,none,hothiphop.parents,hot.parents
2019,1,WCR2019_1575,3,WCR2019_0223,WCR2019_0641,within-group subordinate,within-group subordinate,278,208,70,63,55,271,263,1,99999,6049,6158,4546,0.127787101414529,0,0,NA,NA,none,hothiphop.parents,hot.parents
2019,1,WCR2019_1626,1,WCR2019_0223,WCR2019_0641,within-group subordinate,within-group subordinate,328,249,79,43,93,292,342,1,99999,5948,6051,4472,0.0925405933341472,0,0,NA,NA,none,hothiphop.parents,hot.parents
2019,1,WCR2019_1626,2,WCR2019_0223,WCR2019_0087,within-group subordinate,within-group subordinate,338,278,60,43,48,321,326,1,99999,5948,7177,5183,0.0925405933341472,0,0,NA,NA,none,hothiphop.parents,hot.parents
2019,1,WCR2019_1626,3,WCR2019_0126,WCR2019_0641,within-group subordinate,within-group subordinate,343,218,125,109,93,327,311,1,99999,5206,6051,3888,0.0925405933341472,0,0,NA,NA,none,hothiphop.parents,hot.parents
2019,1,WCR2019_1634,1,WCR2019_0420,WCR2019_0325,within-group subordinate,within-group subordinate,10,8,2,2,0,10,8,1,99999,8295,8264,8251,0.0530622067139935,0,0,NA,NA,none,hothiphop.parents,hot.parents
2019,1,WCR2019_1634,2,WCR2019_0474,WCR2019_0325,within-group subordinate,within-group subordinate,53,43,10,10,0,53,43,1,99999,7974,8264,7931,0.0530622067139935,0,0,NA,NA,none,hothiphop.parents,hot.parents
2019,1,WCR2019_1634,3,WCR2019_0064,WCR2019_0325,within-group subordinate,within-group subordinate,59,43,16,16,0,59,43,1,99999,7251,8264,7208,0.0530622067139935,0,0,NA,NA,none,hothiphop.parents,hot.parents
2019,1,WCR2019_1635,1,WCR2019_0223,WCR2019_0641,within-group subordinate,within-group subordinate,221,196,25,24,22,220,218,1,99999,5872,5982,4415,0.150265464872206,0,0,NA,NA,none,hothiphop.parents,hot.parents
2019,1,WCR2019_1635,2,WCR2019_0223,WCR2019_0327,within-group subordinate,within-group subordinate,252,225,27,24,8,249,233,1,99999,5872,7950,5787,0.150265464872206,0,0,NA,NA,none,hothiphop.parents,hot.parents
2019,1,WCR2019_1635,3,WCR2019_0223,WCR2019_0075,within-group subordinate,within-group subordinate,261,231,30,24,17,255,248,1,99999,5872,7578,5459,0.150265464872206,0,0,NA,NA,none,hothiphop.parents,hot.parents
2019,1,WCR2019_1636,1,WCR2019_0223,WCR2019_0641,within-group subordinate,within-group subordinate,246,163,83,106,27,269,190,1,99999,6027,6134,4526,0.134400192515943,0,0,NA,NA,none,hothiphop.parents,hot.parents
2019,1,WCR2019_1636,2,WCR2019_0008,WCR2019_0641,within-group subordinate,within-group subordinate,248,211,37,17,27,228,238,1,99999,8174,6134,6047,0.134400192515943,0,0,NA,NA,none,hothiphop.parents,hot.parents
2019,1,WCR2019_1636,3,WCR2019_0474,WCR2019_0641,within-group subordinate,within-group subordinate,251,219,32,15,27,234,246,1,99999,7976,6134,5908,0.134400192515943,0,0,NA,NA,none,hothiphop.parents,hot.parents
2019,1,WCR2019_1638,1,WCR2019_0223,WCR2019_0641,within-group subordinate,within-group subordinate,191,170,21,25,8,195,178,1,99999,5928,6021,4447,0.167994118367847,0,0,NA,NA,none,hothiphop.parents,hot.parents
2019,1,WCR2019_1638,2,WCR2019_0008,WCR2019_0641,within-group subordinate,within-group subordinate,200,193,7,1,8,194,201,1,99999,8030,6021,5939,0.167994118367847,0,0,NA,NA,none,hothiphop.parents,hot.parents
2019,1,WCR2019_1638,3,WCR2019_0441,WCR2019_0641,within-group subordinate,within-group subordinate,200,192,8,4,8,196,200,1,99999,8138,6021,6004,0.167994118367847,0,0,NA,NA,none,hothiphop.parents,hot.parents
2019,1,WCR2019_1639,1,WCR2019_0223,WCR2019_0641,within-group subordinate,within-group subordinate,235,176,59,91,25,267,201,1,99999,6052,6159,4545,0.146434991012582,0,0,NA,NA,none,hothiphop.parents,hot.parents
2019,1,WCR2019_1639,2,WCR2019_0165,WCR2019_0641,within-group subordinate,within-group subordinate,249,224,25,7,25,231,249,1,99999,8323,6159,6141,0.146434991012582,0,0,NA,NA,none,hothiphop.parents,hot.parents
2019,1,WCR2019_1639,3,WCR2019_0263,WCR2019_0641,within-group subordinate,within-group subordinate,262,231,31,11,25,242,256,1,99999,8292,6159,6125,0.146434991012582,0,0,NA,NA,none,hothiphop.parents,hot.parents
2019,1,WCR2019_1640,1,WCR2019_0223,WCR2019_0641,within-group subordinate,within-group subordinate,214,194,20,16,10,210,204,1,99999,6003,6108,4505,0.174075863735202,0,0,NA,NA,none,hothiphop.parents,hot.parents
2019,1,WCR2019_1640,2,WCR2019_0223,WCR2019_0088,within-group subordinate,within-group subordinate,222,207,15,16,3,223,210,1,99999,6003,7324,5294,0.174075863735202,0,0,NA,NA,none,hothiphop.parents,hot.parents
2019,1,WCR2019_1640,3,WCR2019_0223,WCR2019_0327,within-group subordinate,within-group subordinate,230,211,19,16,4,227,215,1,99999,6003,8128,5918,0.174075863735202,0,0,NA,NA,none,hothiphop.parents,hot.parents
2019,1,WCR2019_1641,1,WCR2019_0420,WCR2019_0325,within-group subordinate,within-group subordinate,6,3,3,2,1,5,4,1,99999,8246,8216,8202,0.0358223405542781,0,0,NA,NA,none,hothiphop.parents,hot.parents
2019,1,WCR2019_1641,2,WCR2019_0474,WCR2019_0325,within-group subordinate,within-group subordinate,47,40,7,7,1,47,41,1,99999,7930,8216,7887,0.0358223405542781,0,0,NA,NA,none,hothiphop.parents,hot.parents
2019,1,WCR2019_1641,3,WCR2019_0420,WCR2019_0592,within-group subordinate,within-group subordinate,52,29,23,2,21,31,50,1,99999,8246,8232,8217,0.0358223405542781,0,0,NA,NA,none,hothiphop.parents,hot.parents
2019,1,WCR2019_1642,1,WCR2019_0223,WCR2019_0285,within-group subordinate,within-group subordinate,237,201,36,32,7,233,208,1,99999,5950,8161,5930,0.13890243902439,0,0,NA,NA,none,hothiphop.parents,hot.parents
2019,1,WCR2019_1642,2,WCR2019_0223,WCR2019_0641,within-group subordinate,within-group subordinate,264,215,49,32,40,247,255,1,99999,5950,6053,4472,0.13890243902439,0,0,NA,NA,none,hothiphop.parents,hot.parents
2019,1,WCR2019_1642,3,WCR2019_0219,WCR2019_0285,within-group subordinate,within-group subordinate,275,211,64,58,7,269,218,1,99999,7428,8161,7398,0.13890243902439,0,0,NA,NA,none,hothiphop.parents,hot.parents
2019,1,WCR2019_1643,1,WCR2019_0223,WCR2019_0641,within-group subordinate,within-group subordinate,338,229,109,75,121,304,350,1,99999,6028,6136,4525,0.0890946254659132,0,0,NA,NA,none,hothiphop.parents,hot.parents
2019,1,WCR2019_1643,2,WCR2019_0223,WCR2019_0087,within-group subordinate,within-group subordinate,362,270,92,75,98,345,368,1,99999,6028,7262,5238,0.0890946254659132,0,0,NA,NA,none,hothiphop.parents,hot.parents
2019,1,WCR2019_1643,3,WCR2019_0126,WCR2019_0641,within-group subordinate,within-group subordinate,373,221,152,155,121,376,342,1,99999,5276,6136,3935,0.0890946254659132,0,0,NA,NA,none,hothiphop.parents,hot.parents
2019,1,WCR2019_1644,1,WCR2019_0223,WCR2019_0641,within-group subordinate,within-group subordinate,335,263,72,48,86,311,349,1,99999,6025,6137,4528,0.0887872954764196,0,0,NA,NA,none,hothiphop.parents,hot.parents
2019,1,WCR2019_1644,2,WCR2019_0223,WCR2019_0087,within-group subordinate,within-group subordinate,346,291,55,48,41,339,332,1,99999,6025,7258,5234,0.0887872954764196,0,0,NA,NA,none,hothiphop.parents,hot.parents
2019,1,WCR2019_1644,3,WCR2019_0223,WCR2019_0234,within-group subordinate,within-group subordinate,368,295,73,48,58,343,353,1,99999,6025,8206,5969,0.0887872954764196,0,0,NA,NA,none,hothiphop.parents,hot.parents
2019,1,WCR2019_1645,1,WCR2019_0474,WCR2019_0405,within-group subordinate,within-group subordinate,66,53,13,14,0,67,53,1,99999,7962,8129,7815,0.025081393946702,0,0,NA,NA,none,hothiphop.parents,hot.parents
2019,1,WCR2019_1645,2,WCR2019_0256,WCR2019_0405,within-group subordinate,within-group subordinate,67,50,17,17,0,67,50,1,99999,8229,8129,8066,0.025081393946702,0,0,NA,NA,none,hothiphop.parents,hot.parents
2019,1,WCR2019_1645,3,WCR2019_0441,WCR2019_0405,within-group subordinate,within-group subordinate,68,55,13,13,0,68,55,1,99999,8270,8129,8106,0.025081393946702,0,0,NA,NA,none,hothiphop.parents,hot.parents
2019,1,WCR2019_1646,1,WCR2019_0223,WCR2019_0641,within-group subordinate,within-group subordinate,286,230,56,28,71,258,301,1,99999,6046,6147,4539,0.141708663306935,0,0,NA,NA,none,hothiphop.parents,hot.parents
2019,1,WCR2019_1646,2,WCR2019_0223,WCR2019_0161,within-group subordinate,within-group subordinate,298,267,31,28,25,295,292,1,99999,6046,8200,5951,0.141708663306935,0,0,NA,NA,none,hothiphop.parents,hot.parents
2019,1,WCR2019_1646,3,WCR2019_0223,WCR2019_0327,within-group subordinate,within-group subordinate,306,272,34,28,27,300,299,1,99999,6046,8185,5962,0.141708663306935,0,0,NA,NA,none,hothiphop.parents,hot.parents
2019,1,WCR2019_1647,1,WCR2019_0223,WCR2019_0641,within-group subordinate,within-group subordinate,316,262,54,37,64,299,326,1,99999,6050,6157,4543,0.118422629749491,0,0,NA,NA,none,hothiphop.parents,hot.parents
2019,1,WCR2019_1647,2,WCR2019_0223,WCR2019_0537,within-group subordinate,within-group subordinate,355,302,53,37,41,339,343,1,99999,6050,8327,6040,0.118422629749491,0,0,NA,NA,none,hothiphop.parents,hot.parents
2019,1,WCR2019_1647,3,WCR2019_0223,WCR2019_0122,within-group subordinate,within-group subordinate,356,308,48,37,22,345,330,1,99999,6050,8278,6001,0.118422629749491,0,0,NA,NA,none,hothiphop.parents,hot.parents
2019,1,WCR2019_1648,1,WCR2019_0223,WCR2019_0641,within-group subordinate,within-group subordinate,269,211,58,35,62,246,273,1,99999,6021,6134,4527,0.133742626700373,0,0,NA,NA,none,hothiphop.parents,hot.parents
2019,1,WCR2019_1648,2,WCR2019_0360,WCR2019_0641,within-group subordinate,within-group subordinate,273,212,61,2,62,214,274,1,99999,8141,6134,6021,0.133742626700373,0,0,NA,NA,none,hothiphop.parents,hot.parents
2019,1,WCR2019_1648,3,WCR2019_0360,WCR2019_0327,within-group subordinate,within-group subordinate,279,262,17,2,16,264,278,1,99999,8141,8157,7993,0.133742626700373,0,0,NA,NA,none,hothiphop.parents,hot.parents
2019,1,WCR2019_1649,1,WCR2019_0223,WCR2019_0641,within-group subordinate,within-group subordinate,250,175,75,76,66,251,241,1,99999,5925,6040,4454,0.106208750916646,0,0,NA,NA,none,hothiphop.parents,hot.parents
2019,1,WCR2019_1649,2,WCR2019_0223,WCR2019_0327,within-group subordinate,within-group subordinate,280,198,82,76,20,274,218,1,99999,5925,8033,5839,0.106208750916646,0,0,NA,NA,none,hothiphop.parents,hot.parents
2019,1,WCR2019_1649,3,WCR2019_0008,WCR2019_0327,within-group subordinate,within-group subordinate,282,251,31,19,20,270,271,1,99999,8049,8033,7901,0.106208750916646,0,0,NA,NA,none,hothiphop.parents,hot.parents
2019,1,WCR2019_1650,1,WCR2019_0441,WCR2019_0519,within-group subordinate,within-group subordinate,49,45,4,3,1,48,46,1,99999,7532,7511,7492,0.111626059322034,0,0,NA,NA,none,hothiphop.parents,hot.parents
2019,1,WCR2019_1650,2,WCR2019_0263,WCR2019_0519,within-group subordinate,within-group subordinate,53,49,4,3,1,52,50,1,99999,7500,7511,7460,0.111626059322034,0,0,NA,NA,none,hothiphop.parents,hot.parents
2019,1,WCR2019_1650,3,WCR2019_0252,WCR2019_0519,within-group subordinate,within-group subordinate,57,54,3,2,1,56,55,1,99999,7505,7511,7468,0.111626059322034,0,0,NA,NA,none,hothiphop.parents,hot.parents
2019,1,WCR2019_1651,1,WCR2019_0543,WCR2019_0641,within-group subordinate,within-group subordinate,254,170,84,6,78,176,248,1,99999,8176,6082,6036,0.095995145631068,0,0,NA,NA,none,hothiphop.parents,hot.parents
2019,1,WCR2019_1651,2,WCR2019_0543,WCR2019_0327,within-group subordinate,within-group subordinate,259,215,44,6,38,221,253,1,99999,8176,8091,8032,0.095995145631068,0,0,NA,NA,none,hothiphop.parents,hot.parents
2019,1,WCR2019_1651,3,WCR2019_0543,WCR2019_0122,within-group subordinate,within-group subordinate,274,214,60,6,54,220,268,1,99999,8176,8175,8111,0.095995145631068,0,0,NA,NA,none,hothiphop.parents,hot.parents
2019,1,WCR2019_1652,1,WCR2019_0567,WCR2019_0066,within-group subordinate,within-group subordinate,14,9,5,3,2,12,11,1,99999,8214,8261,8170,0.116542258608235,0,0,NA,NA,none,hothiphop.parents,hot.parents
2019,1,WCR2019_1652,2,WCR2019_0567,WCR2019_0313,within-group subordinate,within-group subordinate,224,188,36,3,34,191,222,1,99999,8214,8255,8165,0.116542258608235,0,0,NA,NA,none,hothiphop.parents,hot.parents
2019,1,WCR2019_1652,3,WCR2019_0567,WCR2019_0327,within-group subordinate,within-group subordinate,232,210,22,3,21,213,231,1,99999,8214,8157,8068,0.116542258608235,0,0,NA,NA,none,hothiphop.parents,hot.parents
2019,1,WCR2019_1653,1,WCR2019_0223,WCR2019_0641,within-group subordinate,within-group subordinate,346,272,74,47,77,319,349,1,99999,5999,6094,4505,0.100762988979048,0,0,NA,NA,none,hothiphop.parents,hot.parents
2019,1,WCR2019_1653,2,WCR2019_0223,WCR2019_0087,within-group subordinate,within-group subordinate,360,300,60,47,43,347,343,1,99999,5999,7223,5222,0.100762988979048,0,0,NA,NA,none,hothiphop.parents,hot.parents
2019,1,WCR2019_1653,3,WCR2019_0223,WCR2019_0327,within-group subordinate,within-group subordinate,374,321,53,47,30,368,351,1,99999,5999,8107,5914,0.100762988979048,0,0,NA,NA,none,hothiphop.parents,hot.parents
2019,1,WCR2019_1654,1,WCR2019_0223,WCR2019_0641,within-group subordinate,within-group subordinate,184,122,62,75,26,197,148,1,99999,5780,5903,4337,0.122438780609695,0,0,NA,NA,none,hothiphop.parents,hot.parents
2019,1,WCR2019_1654,2,WCR2019_0008,WCR2019_0641,within-group subordinate,within-group subordinate,197,167,30,10,26,177,193,1,99999,7875,5903,5822,0.122438780609695,0,0,NA,NA,none,hothiphop.parents,hot.parents
2019,1,WCR2019_1654,3,WCR2019_0192,WCR2019_0641,within-group subordinate,within-group subordinate,201,172,29,6,26,178,198,1,99999,7974,5903,5882,0.122438780609695,0,0,NA,NA,none,hothiphop.parents,hot.parents
2019,1,WCR2019_1655,1,WCR2019_0357,WCR2019_0327,within-group subordinate,within-group subordinate,216,187,29,6,24,193,211,1,99999,8305,8184,8155,0.114470842332613,0,0,NA,NA,none,hothiphop.parents,hot.parents
2019,1,WCR2019_1655,2,WCR2019_0357,WCR2019_0161,within-group subordinate,within-group subordinate,239,197,42,6,37,203,234,1,99999,8305,8201,8172,0.114470842332613,0,0,NA,NA,none,hothiphop.parents,hot.parents
2019,1,WCR2019_1655,3,WCR2019_0357,WCR2019_0641,within-group subordinate,within-group subordinate,239,151,88,6,84,157,235,1,99999,8305,6148,6124,0.114470842332613,0,0,NA,NA,none,hothiphop.parents,hot.parents
2019,1,WCR2019_1656,1,WCR2019_0223,WCR2019_0641,within-group subordinate,within-group subordinate,234,195,39,37,36,232,231,1,99999,5921,6023,4448,0.132262809512135,0,0,NA,NA,none,hothiphop.parents,hot.parents
2019,1,WCR2019_1656,2,WCR2019_0267,WCR2019_0327,within-group subordinate,within-group subordinate,235,218,17,6,13,224,231,1,99999,8100,8008,7953,0.132262809512135,0,0,NA,NA,none,hothiphop.parents,hot.parents
2019,1,WCR2019_1656,3,WCR2019_0267,WCR2019_0641,within-group subordinate,within-group subordinate,239,201,38,6,36,207,237,1,99999,8100,6023,5986,0.132262809512135,0,0,NA,NA,none,hothiphop.parents,hot.parents
2019,1,WCR2019_1657,1,WCR2019_0223,WCR2019_0641,within-group subordinate,within-group subordinate,337,258,79,45,88,303,346,1,99999,6043,6144,4537,0.102570261830411,0,0,NA,NA,none,hothiphop.parents,hot.parents
2019,1,WCR2019_1657,2,WCR2019_0219,WCR2019_0641,within-group subordinate,within-group subordinate,338,242,96,34,88,276,330,1,99999,7549,6144,5602,0.102570261830411,0,0,NA,NA,none,hothiphop.parents,hot.parents
2019,1,WCR2019_1657,3,WCR2019_0223,WCR2019_0087,within-group subordinate,within-group subordinate,352,289,63,45,55,334,344,1,99999,6043,7266,5248,0.102570261830411,0,0,NA,NA,none,hothiphop.parents,hot.parents
2019,1,WCR2019_1658,1,WCR2019_0223,WCR2019_0641,within-group subordinate,within-group subordinate,256,225,31,24,30,249,255,1,99999,6048,6145,4542,0.149327246516098,0,0,NA,NA,none,hothiphop.parents,hot.parents
2019,1,WCR2019_1658,2,WCR2019_0223,WCR2019_0407,within-group subordinate,within-group subordinate,264,238,26,24,3,262,241,1,99999,6048,8302,6033,0.149327246516098,0,0,NA,NA,none,hothiphop.parents,hot.parents
2019,1,WCR2019_1658,3,WCR2019_0440,WCR2019_0407,within-group subordinate,within-group subordinate,293,258,35,32,3,290,261,1,99999,6919,8302,6902,0.149327246516098,0,0,NA,NA,none,hothiphop.parents,hot.parents
2019,1,WCR2019_1659,1,WCR2019_0223,WCR2019_0641,within-group subordinate,within-group subordinate,310,247,63,51,71,298,318,1,99999,6052,6148,4541,0.113322940400528,0,0,NA,NA,none,hothiphop.parents,hot.parents
2019,1,WCR2019_1659,2,WCR2019_0223,WCR2019_0327,within-group subordinate,within-group subordinate,349,294,55,51,25,345,319,1,99999,6052,8190,5968,0.113322940400528,0,0,NA,NA,none,hothiphop.parents,hot.parents
2019,1,WCR2019_1659,3,WCR2019_0223,WCR2019_0161,within-group subordinate,within-group subordinate,367,308,59,51,36,359,344,1,99999,6052,8205,5957,0.113322940400528,0,0,NA,NA,none,hothiphop.parents,hot.parents
2019,1,WCR2019_1660,1,WCR2019_0428,WCR2019_0519,within-group subordinate,within-group subordinate,187,155,32,5,27,160,182,1,99999,8332,8314,8287,0.13122009569378,0,0,NA,NA,none,hothiphop.parents,hot.parents
2019,1,WCR2019_1660,2,WCR2019_0428,WCR2019_0327,within-group subordinate,within-group subordinate,217,195,22,5,17,200,212,1,99999,8332,8210,8182,0.13122009569378,0,0,NA,NA,none,hothiphop.parents,hot.parents
2019,1,WCR2019_1660,3,WCR2019_0428,WCR2019_0257,within-group subordinate,within-group subordinate,220,181,39,5,34,186,215,1,99999,8332,8322,8294,0.13122009569378,0,0,NA,NA,none,hothiphop.parents,hot.parents
2019,1,WCR2019_1661,1,WCR2019_0223,WCR2019_0641,within-group subordinate,within-group subordinate,279,211,68,60,54,271,265,1,99999,5991,6102,4502,0.126254686177289,0,0,NA,NA,none,hothiphop.parents,hot.parents
2019,1,WCR2019_1661,2,WCR2019_0223,WCR2019_0327,within-group subordinate,within-group subordinate,313,249,64,60,15,309,264,1,99999,5991,8118,5905,0.126254686177289,0,0,NA,NA,none,hothiphop.parents,hot.parents
2019,1,WCR2019_1661,3,WCR2019_0440,WCR2019_0641,within-group subordinate,within-group subordinate,320,239,81,70,54,309,293,1,99999,6872,6102,5113,0.126254686177289,0,0,NA,NA,none,hothiphop.parents,hot.parents
2019,1,WCR2019_1662,1,WCR2019_0223,WCR2019_0641,within-group subordinate,within-group subordinate,205,170,35,30,26,200,196,1,99999,5556,5654,4180,0.142333856619571,0,0,NA,NA,none,hothiphop.parents,hot.parents
2019,1,WCR2019_1662,2,WCR2019_0223,WCR2019_0407,within-group subordinate,within-group subordinate,206,173,33,30,5,203,178,1,99999,5556,7627,5546,0.142333856619571,0,0,NA,NA,none,hothiphop.parents,hot.parents
2019,1,WCR2019_1662,3,WCR2019_0440,WCR2019_0407,within-group subordinate,within-group subordinate,215,187,28,24,5,211,192,1,99999,6365,7627,6353,0.142333856619571,0,0,NA,NA,none,hothiphop.parents,hot.parents
2019,1,WCR2019_1663,1,WCR2019_0252,WCR2019_0617,within-group subordinate,within-group subordinate,88,65,23,8,15,73,80,1,99999,8226,8250,8202,0.0268277945619335,0,0,NA,NA,none,hothiphop.parents,hot.parents
2019,1,WCR2019_1663,2,WCR2019_0441,WCR2019_0617,within-group subordinate,within-group subordinate,88,64,24,12,15,76,79,1,99999,8253,8250,8229,0.0268277945619335,0,0,NA,NA,none,hothiphop.parents,hot.parents
2019,1,WCR2019_1663,3,WCR2019_0474,WCR2019_0617,within-group subordinate,within-group subordinate,92,72,20,9,15,81,87,1,99999,7943,8250,7918,0.0268277945619335,0,0,NA,NA,none,hothiphop.parents,hot.parents
2019,1,WCR2019_1664,1,WCR2019_0223,WCR2019_0641,within-group subordinate,within-group subordinate,210,151,59,39,49,190,200,1,99999,5555,5648,4184,0.108185985592665,0,0,NA,NA,none,hothiphop.parents,hot.parents
2019,1,WCR2019_1664,2,WCR2019_0223,WCR2019_0327,within-group subordinate,within-group subordinate,236,190,46,39,18,229,208,1,99999,5555,7498,5477,0.108185985592665,0,0,NA,NA,none,hothiphop.parents,hot.parents
2019,1,WCR2019_1664,3,WCR2019_0223,WCR2019_0075,within-group subordinate,within-group subordinate,237,180,57,39,43,219,223,1,99999,5555,7131,5156,0.108185985592665,0,0,NA,NA,none,hothiphop.parents,hot.parents
2019,1,WCR2019_1665,1,WCR2019_0223,WCR2019_0641,within-group subordinate,within-group subordinate,330,268,62,34,75,302,343,1,99999,5979,6098,4496,0.0984142355647016,0,0,NA,NA,none,hothiphop.parents,hot.parents
2019,1,WCR2019_1665,2,WCR2019_0223,WCR2019_0087,within-group subordinate,within-group subordinate,334,290,44,34,37,324,327,1,99999,5979,7239,5216,0.0984142355647016,0,0,NA,NA,none,hothiphop.parents,hot.parents
2019,1,WCR2019_1665,3,WCR2019_0126,WCR2019_0641,within-group subordinate,within-group subordinate,356,237,119,117,75,354,312,1,99999,5242,6098,3912,0.0984142355647016,0,0,NA,NA,none,hothiphop.parents,hot.parents
2019,1,WCR2019_1666,1,WCR2019_0468,WCR2019_0124,within-group subordinate,within-group subordinate,138,92,46,3,43,95,135,1,99999,8093,8096,8067,0.135188377246984,0,0,NA,NA,none,hothiphop.parents,hot.parents
2019,1,WCR2019_1666,2,WCR2019_0468,WCR2019_0413,within-group subordinate,within-group subordinate,143,95,48,3,45,98,140,1,99999,8093,8053,8025,0.135188377246984,0,0,NA,NA,none,hothiphop.parents,hot.parents
2019,1,WCR2019_1666,3,WCR2019_0468,WCR2019_0327,within-group subordinate,within-group subordinate,195,182,13,3,10,185,192,1,99999,8093,7972,7943,0.135188377246984,0,0,NA,NA,none,hothiphop.parents,hot.parents
2019,1,WCR2019_1667,1,WCR2019_0223,WCR2019_0641,within-group subordinate,within-group subordinate,306,244,62,38,69,282,313,1,99999,6024,6132,4521,0.109467099723325,0,0,NA,NA,none,hothiphop.parents,hot.parents
2019,1,WCR2019_1667,2,WCR2019_0223,WCR2019_0161,within-group subordinate,within-group subordinate,345,299,46,38,36,337,335,1,99999,6024,8180,5929,0.109467099723325,0,0,NA,NA,none,hothiphop.parents,hot.parents
2019,1,WCR2019_1667,3,WCR2019_0223,WCR2019_0327,within-group subordinate,within-group subordinate,345,296,49,38,30,334,326,1,99999,6024,8163,5939,0.109467099723325,0,0,NA,NA,none,hothiphop.parents,hot.parents
2019,1,WCR2019_1668,1,WCR2019_0223,WCR2019_0641,within-group subordinate,within-group subordinate,236,220,16,17,7,237,227,1,99999,5985,6080,4488,0.182347235693501,0,0,NA,NA,none,hothiphop.parents,hot.parents
2019,1,WCR2019_1668,2,WCR2019_0223,WCR2019_0088,within-group subordinate,within-group subordinate,255,240,15,17,5,257,245,1,99999,5985,7299,5283,0.182347235693501,0,0,NA,NA,none,hothiphop.parents,hot.parents
2019,1,WCR2019_1668,3,WCR2019_0223,WCR2019_0039,within-group subordinate,within-group subordinate,256,240,16,17,4,257,244,1,99999,5985,8129,5888,0.182347235693501,0,0,NA,NA,none,hothiphop.parents,hot.parents
2019,1,WCR2019_1669,1,WCR2019_0223,WCR2019_0641,within-group subordinate,within-group subordinate,230,191,39,37,29,228,220,1,99999,5986,6095,4497,0.139393939393939,0,0,NA,NA,none,hothiphop.parents,hot.parents
2019,1,WCR2019_1669,2,WCR2019_0223,WCR2019_0327,within-group subordinate,within-group subordinate,263,224,39,37,7,261,231,1,99999,5986,8101,5900,0.139393939393939,0,0,NA,NA,none,hothiphop.parents,hot.parents
2019,1,WCR2019_1669,3,WCR2019_0223,WCR2019_0075,within-group subordinate,within-group subordinate,272,231,41,37,19,268,250,1,99999,5986,7715,5562,0.139393939393939,0,0,NA,NA,none,hothiphop.parents,hot.parents
2019,1,WCR2019_1670,1,WCR2019_0223,WCR2019_0641,within-group subordinate,within-group subordinate,285,223,62,49,70,272,293,1,99999,6022,6126,4522,0.111914227201542,0,0,NA,NA,none,hothiphop.parents,hot.parents
2019,1,WCR2019_1670,2,WCR2019_0223,WCR2019_0327,within-group subordinate,within-group subordinate,313,260,53,49,28,309,288,1,99999,6022,8152,5938,0.111914227201542,0,0,NA,NA,none,hothiphop.parents,hot.parents
2019,1,WCR2019_1670,3,WCR2019_0223,WCR2019_0161,within-group subordinate,within-group subordinate,320,264,56,49,45,313,309,1,99999,6022,8171,5929,0.111914227201542,0,0,NA,NA,none,hothiphop.parents,hot.parents
2019,1,WCR2019_1672,1,WCR2019_0074,WCR2019_0641,within-group subordinate,within-group subordinate,296,228,68,30,63,258,291,1,99999,8063,6167,5948,0.128576559320005,0,0,NA,NA,none,hothiphop.parents,hot.parents
2019,1,WCR2019_1672,2,WCR2019_0139,WCR2019_0641,within-group subordinate,within-group subordinate,297,224,73,33,63,257,287,1,99999,8338,6167,6154,0.128576559320005,0,0,NA,NA,none,hothiphop.parents,hot.parents
2019,1,WCR2019_1672,3,WCR2019_0139,WCR2019_0327,within-group subordinate,within-group subordinate,302,254,48,33,24,287,278,1,99999,8338,8202,8187,0.128576559320005,0,0,NA,NA,none,hothiphop.parents,hot.parents
2019,1,WCR2019_1673,1,WCR2019_0223,WCR2019_0641,within-group subordinate,within-group subordinate,348,260,88,53,90,313,350,1,99999,6027,6125,4521,0.0925613866153105,0,0,NA,NA,none,hothiphop.parents,hot.parents
2019,1,WCR2019_1673,2,WCR2019_0266,WCR2019_0641,within-group subordinate,within-group subordinate,349,246,103,27,90,273,336,1,99999,8187,6125,6035,0.0925613866153105,0,0,NA,NA,none,hothiphop.parents,hot.parents
2019,1,WCR2019_1673,3,WCR2019_0266,WCR2019_0327,within-group subordinate,within-group subordinate,352,305,47,27,27,332,332,1,99999,8187,8158,8042,0.0925613866153105,0,0,NA,NA,none,hothiphop.parents,hot.parents
2019,1,WCR2019_1674,1,WCR2019_0223,WCR2019_0087,within-group subordinate,within-group subordinate,363,302,61,56,52,358,354,1,99999,6040,7277,5253,0.0991715692159923,0,0,NA,NA,none,hothiphop.parents,hot.parents
2019,1,WCR2019_1674,2,WCR2019_0223,WCR2019_0641,within-group subordinate,within-group subordinate,379,292,87,56,93,348,385,1,99999,6040,6146,4533,0.0991715692159923,0,0,NA,NA,none,hothiphop.parents,hot.parents
2019,1,WCR2019_1674,3,WCR2019_0223,WCR2019_0171,within-group subordinate,within-group subordinate,392,318,74,56,58,374,376,1,99999,6040,8184,5929,0.0991715692159923,0,0,NA,NA,none,hothiphop.parents,hot.parents
2019,1,WCR2019_1675,1,WCR2019_0223,WCR2019_0641,within-group subordinate,within-group subordinate,384,294,90,58,102,352,396,1,99999,6046,6144,4536,0.107644305772231,0,0,NA,NA,none,hothiphop.parents,hot.parents
2019,1,WCR2019_1675,2,WCR2019_0223,WCR2019_0327,within-group subordinate,within-group subordinate,424,361,63,58,50,419,411,1,99999,6046,8183,5960,0.107644305772231,0,0,NA,NA,none,hothiphop.parents,hot.parents
2019,1,WCR2019_1675,3,WCR2019_0223,WCR2019_0075,within-group subordinate,within-group subordinate,428,343,85,58,89,401,432,1,99999,6046,7788,5615,0.107644305772231,0,0,NA,NA,none,hothiphop.parents,hot.parents
2019,1,WCR2019_1676,1,WCR2019_0167,WCR2019_0023,within-group subordinate,within-group subordinate,256,199,57,53,7,252,206,1,99999,8257,8317,8243,0.111151122314248,0,0,NA,NA,none,hothiphop.parents,hot.parents
2019,1,WCR2019_1676,2,WCR2019_0223,WCR2019_0023,within-group subordinate,within-group subordinate,260,211,49,44,7,255,218,1,99999,6041,8317,6030,0.111151122314248,0,0,NA,NA,none,hothiphop.parents,hot.parents
2019,1,WCR2019_1676,3,WCR2019_0139,WCR2019_0023,within-group subordinate,within-group subordinate,266,205,61,56,7,261,212,1,99999,8318,8317,8304,0.111151122314248,0,0,NA,NA,none,hothiphop.parents,hot.parents
2019,1,WCR2019_1677,1,WCR2019_0192,WCR2019_0198,within-group subordinate,within-group subordinate,266,207,59,59,3,266,210,1,99999,8317,8306,8276,0.0994369234455493,0,0,NA,NA,none,hothiphop.parents,hot.parents
2019,1,WCR2019_1677,2,WCR2019_0361,WCR2019_0198,within-group subordinate,within-group subordinate,266,192,74,73,3,265,195,1,99999,7959,8306,7924,0.0994369234455493,0,0,NA,NA,none,hothiphop.parents,hot.parents
2019,1,WCR2019_1677,3,WCR2019_0008,WCR2019_0198,within-group subordinate,within-group subordinate,269,205,64,64,3,269,208,1,99999,8210,8306,8169,0.0994369234455493,0,0,NA,NA,none,hothiphop.parents,hot.parents
2019,1,WCR2019_1678,1,WCR2019_0008,WCR2019_0065,within-group subordinate,within-group subordinate,244,200,44,41,4,241,204,1,99999,8196,8307,8170,0.125885035401416,0,0,NA,NA,none,hothiphop.parents,hot.parents
2019,1,WCR2019_1678,2,WCR2019_0256,WCR2019_0065,within-group subordinate,within-group subordinate,253,200,53,50,4,250,204,1,99999,8269,8307,8243,0.125885035401416,0,0,NA,NA,none,hothiphop.parents,hot.parents
2019,1,WCR2019_1678,3,WCR2019_0487,WCR2019_0065,within-group subordinate,within-group subordinate,256,206,50,46,4,252,210,1,99999,8303,8307,8277,0.125885035401416,0,0,NA,NA,none,hothiphop.parents,hot.parents
2019,1,WCR2019_1679,1,WCR2019_0223,WCR2019_0641,within-group subordinate,within-group subordinate,223,193,30,25,20,218,213,1,99999,6053,6154,4544,0.158829174664107,0,0,NA,NA,none,hothiphop.parents,hot.parents
2019,1,WCR2019_1679,2,WCR2019_0223,WCR2019_0161,within-group subordinate,within-group subordinate,245,221,24,25,9,246,230,1,99999,6053,8204,5959,0.158829174664107,0,0,NA,NA,none,hothiphop.parents,hot.parents
2019,1,WCR2019_1679,3,WCR2019_0223,WCR2019_0206,within-group subordinate,within-group subordinate,250,219,31,25,17,244,236,1,99999,6053,8267,6007,0.158829174664107,0,0,NA,NA,none,hothiphop.parents,hot.parents
2019,1,WCR2019_1680,1,WCR2019_0524,WCR2019_0641,within-group subordinate,within-group subordinate,276,197,79,4,80,201,277,1,99999,8243,6126,6083,0.116066047969145,0,0,NA,NA,none,hothiphop.parents,hot.parents
2019,1,WCR2019_1680,2,WCR2019_0524,WCR2019_0327,within-group subordinate,within-group subordinate,277,251,26,4,23,255,274,1,99999,8243,8147,8096,0.116066047969145,0,0,NA,NA,none,hothiphop.parents,hot.parents
2019,1,WCR2019_1680,3,WCR2019_0223,WCR2019_0641,within-group subordinate,within-group subordinate,302,224,78,50,80,274,304,1,99999,6016,6126,4521,0.116066047969145,0,0,NA,NA,none,hothiphop.parents,hot.parents
2019,1,WCR2019_1681,1,WCR2019_0223,WCR2019_0239,within-group subordinate,within-group subordinate,284,225,59,58,3,283,228,1,99999,6059,8285,6020,0.0943599568913902,0,0,NA,NA,none,hothiphop.parents,hot.parents
2019,1,WCR2019_1681,2,WCR2019_0440,WCR2019_0239,within-group subordinate,within-group subordinate,321,255,66,65,3,320,258,1,99999,6941,8285,6890,0.0943599568913902,0,0,NA,NA,none,hothiphop.parents,hot.parents
2019,1,WCR2019_1681,3,WCR2019_0076,WCR2019_0239,within-group subordinate,within-group subordinate,326,255,71,70,3,325,258,1,99999,7190,8285,7128,0.0943599568913902,0,0,NA,NA,none,hothiphop.parents,hot.parents
2019,1,WCR2019_1682,1,WCR2019_0223,WCR2019_0641,within-group subordinate,within-group subordinate,290,225,65,46,76,271,301,1,99999,6058,6157,4547,0.111177668623458,0,0,NA,NA,none,hothiphop.parents,hot.parents
2019,1,WCR2019_1682,2,WCR2019_0223,WCR2019_0327,within-group subordinate,within-group subordinate,345,293,52,46,37,339,330,1,99999,6058,8196,5972,0.111177668623458,0,0,NA,NA,none,hothiphop.parents,hot.parents
2019,1,WCR2019_1682,3,WCR2019_0223,WCR2019_0075,within-group subordinate,within-group subordinate,348,282,66,46,71,328,353,1,99999,6058,7801,5625,0.111177668623458,0,0,NA,NA,none,hothiphop.parents,hot.parents
2019,1,WCR2019_1683,1,WCR2019_0223,WCR2019_0641,within-group subordinate,within-group subordinate,386,304,82,48,101,352,405,1,99999,6061,6157,4550,0.0979758054856869,0,0,NA,NA,none,hothiphop.parents,hot.parents
2019,1,WCR2019_1683,2,WCR2019_0223,WCR2019_0087,within-group subordinate,within-group subordinate,397,340,57,48,55,388,395,1,99999,6061,7288,5265,0.0979758054856869,0,0,NA,NA,none,hothiphop.parents,hot.parents
2019,1,WCR2019_1683,3,WCR2019_0223,WCR2019_0322,within-group subordinate,within-group subordinate,406,341,65,48,53,389,394,1,99999,6061,8313,6039,0.0979758054856869,0,0,NA,NA,none,hothiphop.parents,hot.parents
2019,1,WCR2019_1684,1,WCR2019_0530,WCR2019_0405,within-group subordinate,within-group subordinate,8,2,6,4,2,6,4,1,99999,8316,8193,8150,0.0904306220095694,0,0,NA,NA,none,hothiphop.parents,hot.parents
2019,1,WCR2019_1684,2,WCR2019_0530,WCR2019_0088,within-group subordinate,within-group subordinate,74,58,16,4,14,62,72,1,99999,8316,7391,7353,0.0904306220095694,0,0,NA,NA,none,hothiphop.parents,hot.parents
2019,1,WCR2019_1684,3,WCR2019_0530,WCR2019_0323,within-group subordinate,within-group subordinate,76,65,11,4,9,69,74,1,99999,8316,8340,8297,0.0904306220095694,0,0,NA,NA,none,hothiphop.parents,hot.parents
2019,1,WCR2019_1685,1,WCR2019_0223,WCR2019_0087,within-group subordinate,within-group subordinate,343,284,59,50,49,334,333,1,99999,6025,7259,5238,0.0958458759783263,0,0,NA,NA,none,hothiphop.parents,hot.parents
2019,1,WCR2019_1685,2,WCR2019_0223,WCR2019_0641,within-group subordinate,within-group subordinate,354,272,82,50,95,322,367,1,99999,6025,6127,4524,0.0958458759783263,0,0,NA,NA,none,hothiphop.parents,hot.parents
2019,1,WCR2019_1685,3,WCR2019_0223,WCR2019_0073,within-group subordinate,within-group subordinate,380,311,69,50,64,361,375,1,99999,6025,7917,5708,0.0958458759783263,0,0,NA,NA,none,hothiphop.parents,hot.parents
2019,1,WCR2019_1686,1,WCR2019_0223,WCR2019_0641,within-group subordinate,within-group subordinate,382,298,84,49,90,347,388,1,99999,6064,6169,4554,0.111469919866045,0,0,NA,NA,none,hothiphop.parents,hot.parents
2019,1,WCR2019_1686,2,WCR2019_0126,WCR2019_0641,within-group subordinate,within-group subordinate,388,254,134,147,90,401,344,1,99999,5300,6169,3955,0.111469919866045,0,0,NA,NA,none,hothiphop.parents,hot.parents
2019,1,WCR2019_1686,3,WCR2019_0223,WCR2019_0087,within-group subordinate,within-group subordinate,397,328,69,49,71,377,399,1,99999,6064,7299,5268,0.111469919866045,0,0,NA,NA,none,hothiphop.parents,hot.parents
2019,1,WCR2019_1687,1,WCR2019_0479,WCR2019_0641,within-group subordinate,within-group subordinate,208,171,37,4,35,175,206,1,99999,8021,5954,5930,0.133366447286725,0,0,NA,NA,none,hothiphop.parents,hot.parents
2019,1,WCR2019_1687,2,WCR2019_0479,WCR2019_0206,within-group subordinate,within-group subordinate,213,194,19,4,16,198,210,1,99999,8021,7986,7956,0.133366447286725,0,0,NA,NA,none,hothiphop.parents,hot.parents
2019,1,WCR2019_1687,3,WCR2019_0479,WCR2019_0122,within-group subordinate,within-group subordinate,222,209,13,4,9,213,218,1,99999,8021,7989,7958,0.133366447286725,0,0,NA,NA,none,hothiphop.parents,hot.parents
2019,1,WCR2019_1688,1,WCR2019_0223,WCR2019_0641,within-group subordinate,within-group subordinate,241,179,62,20,77,199,256,1,99999,5738,5814,4311,0.103811944091487,0,0,NA,NA,none,hothiphop.parents,hot.parents
2019,1,WCR2019_1688,2,WCR2019_0223,WCR2019_0327,within-group subordinate,within-group subordinate,249,224,25,20,16,244,240,1,99999,5738,7729,5654,0.103811944091487,0,0,NA,NA,none,hothiphop.parents,hot.parents
2019,1,WCR2019_1688,3,WCR2019_0223,WCR2019_0075,within-group subordinate,within-group subordinate,261,226,35,20,37,246,263,1,99999,5738,7380,5347,0.103811944091487,0,0,NA,NA,none,hothiphop.parents,hot.parents
2019,1,WCR2019_1689,1,WCR2019_0223,WCR2019_0641,within-group subordinate,within-group subordinate,196,185,11,13,6,198,191,1,99999,5908,6004,4434,0.176354921961411,0,0,NA,NA,none,hothiphop.parents,hot.parents
2019,1,WCR2019_1689,2,WCR2019_0223,WCR2019_0088,within-group subordinate,within-group subordinate,213,201,12,13,4,214,205,1,99999,5908,7196,5210,0.176354921961411,0,0,NA,NA,none,hothiphop.parents,hot.parents
2019,1,WCR2019_1689,3,WCR2019_0223,WCR2019_0075,within-group subordinate,within-group subordinate,227,213,14,13,6,226,219,1,99999,5908,7613,5493,0.176354921961411,0,0,NA,NA,none,hothiphop.parents,hot.parents
2019,1,WCR2019_1690,1,WCR2019_0223,WCR2019_0075,within-group subordinate,within-group subordinate,249,207,42,33,39,240,246,1,99999,5928,7600,5507,0.120481927710843,0,0,NA,NA,none,hothiphop.parents,hot.parents
2019,1,WCR2019_1690,2,WCR2019_0223,WCR2019_0641,within-group subordinate,within-group subordinate,250,191,59,33,55,224,246,1,99999,5928,6016,4464,0.120481927710843,0,0,NA,NA,none,hothiphop.parents,hot.parents
2019,1,WCR2019_1690,3,WCR2019_0223,WCR2019_0061,within-group subordinate,within-group subordinate,260,215,45,33,42,248,257,1,99999,5928,7708,5600,0.120481927710843,0,0,NA,NA,none,hothiphop.parents,hot.parents
2019,1,WCR2019_1691,1,WCR2019_0223,WCR2019_0641,within-group subordinate,within-group subordinate,251,205,46,30,52,235,257,1,99999,5900,6003,4441,0.108923076923077,0,0,NA,NA,none,hothiphop.parents,hot.parents
2019,1,WCR2019_1691,2,WCR2019_0126,WCR2019_0641,within-group subordinate,within-group subordinate,298,189,109,126,52,315,241,1,99999,5163,6003,3852,0.108923076923077,0,0,NA,NA,none,hothiphop.parents,hot.parents
2019,1,WCR2019_1691,3,WCR2019_0223,WCR2019_0327,within-group subordinate,within-group subordinate,299,264,35,30,24,294,288,1,99999,5900,7979,5818,0.108923076923077,0,0,NA,NA,none,hothiphop.parents,hot.parents
2019,1,WCR2019_1692,1,WCR2019_0361,WCR2019_0519,within-group subordinate,within-group subordinate,248,208,40,29,22,237,230,1,99999,7958,8297,7917,0.0738343521515043,0,0,NA,NA,none,hothiphop.parents,hot.parents
2019,1,WCR2019_1692,2,WCR2019_0499,WCR2019_0519,within-group subordinate,within-group subordinate,255,214,41,27,22,241,236,1,99999,8302,8297,8258,0.0738343521515043,0,0,NA,NA,none,hothiphop.parents,hot.parents
2019,1,WCR2019_1692,3,WCR2019_0595,WCR2019_0519,within-group subordinate,within-group subordinate,256,221,35,20,22,241,243,1,99999,8329,8297,8283,0.0738343521515043,0,0,NA,NA,none,hothiphop.parents,hot.parents
2019,1,WCR2019_1741,1,WCR2019_0223,WCR2019_0087,within-group subordinate,within-group subordinate,365,296,69,60,57,356,353,1,99999,6065,7287,5267,0.0964418353899605,0,0,NA,NA,none,hothiphop.parents,hot.parents
2019,1,WCR2019_1741,2,WCR2019_0223,WCR2019_0641,within-group subordinate,within-group subordinate,373,273,100,60,111,333,384,1,99999,6065,6160,4554,0.0964418353899605,0,0,NA,NA,none,hothiphop.parents,hot.parents
2019,1,WCR2019_1741,3,WCR2019_0223,WCR2019_0327,within-group subordinate,within-group subordinate,409,339,70,60,53,399,392,1,99999,6065,8197,5980,0.0964418353899605,0,0,NA,NA,none,hothiphop.parents,hot.parents
2019,1,WCR2019_1744,1,WCR2019_0409,WCR2019_0398,within-group subordinate,within-group subordinate,79,51,28,14,18,65,69,1,99999,8294,8298,8268,0.0233033033033033,0,0,NA,NA,none,hothiphop.parents,hot.parents
2019,1,WCR2019_1744,2,WCR2019_0409,WCR2019_0645,within-group subordinate,within-group subordinate,92,58,34,14,23,72,81,1,99999,8294,8308,8278,0.0233033033033033,0,0,NA,NA,none,hothiphop.parents,hot.parents
2019,1,WCR2019_1744,3,WCR2019_0409,WCR2019_0618,within-group subordinate,within-group subordinate,92,56,36,14,28,70,84,1,99999,8294,8275,8245,0.0233033033033033,0,0,NA,NA,none,hothiphop.parents,hot.parents
2019,1,WCR2019_1745,1,WCR2019_0479,WCR2019_0405,within-group subordinate,within-group subordinate,5,2,3,1,2,3,4,1,99999,8003,7882,7853,0.0773061122868169,0,0,NA,NA,none,hothiphop.parents,hot.parents
2019,1,WCR2019_1745,2,WCR2019_0479,WCR2019_0617,within-group subordinate,within-group subordinate,51,34,17,1,16,35,50,1,99999,8003,8009,7980,0.0773061122868169,0,0,NA,NA,none,hothiphop.parents,hot.parents
2019,1,WCR2019_1745,3,WCR2019_0479,WCR2019_0634,within-group subordinate,within-group subordinate,55,37,18,1,17,38,54,1,99999,8003,7995,7966,0.0773061122868169,0,0,NA,NA,none,hothiphop.parents,hot.parents
2019,1,WCR2019_1746,1,WCR2019_0567,WCR2019_0331,within-group subordinate,within-group subordinate,208,163,45,22,25,185,188,1,99999,8153,8220,8126,0.137609117361785,0,0,NA,NA,none,hothiphop.parents,hot.parents
2019,1,WCR2019_1746,2,WCR2019_0567,WCR2019_0327,within-group subordinate,within-group subordinate,250,217,33,22,17,239,234,1,99999,8153,8100,8009,0.137609117361785,0,0,NA,NA,none,hothiphop.parents,hot.parents
2019,1,WCR2019_1746,3,WCR2019_0287,WCR2019_0641,within-group subordinate,within-group subordinate,253,210,43,4,41,214,251,1,99999,8221,6087,6069,0.137609117361785,0,0,NA,NA,none,hothiphop.parents,hot.parents
2019,1,WCR2019_1748,1,WCR2019_0223,WCR2019_0641,within-group subordinate,within-group subordinate,334,271,63,37,69,308,340,1,99999,5960,6057,4474,0.0975164353542732,0,0,NA,NA,none,hothiphop.parents,hot.parents
2019,1,WCR2019_1748,2,WCR2019_0223,WCR2019_0087,within-group subordinate,within-group subordinate,340,288,52,37,44,325,332,1,99999,5960,7196,5194,0.0975164353542732,0,0,NA,NA,none,hothiphop.parents,hot.parents
2019,1,WCR2019_1748,3,WCR2019_0126,WCR2019_0641,within-group subordinate,within-group subordinate,354,239,115,113,69,352,308,1,99999,5206,6057,3881,0.0975164353542732,0,0,NA,NA,none,hothiphop.parents,hot.parents
2019,1,WCR2019_1749,1,WCR2019_0008,WCR2019_0206,within-group subordinate,within-group subordinate,223,195,28,22,9,217,204,1,99999,8093,8156,8027,0.112232490272374,0,0,NA,NA,none,hothiphop.parents,hot.parents
2019,1,WCR2019_1749,2,WCR2019_0192,WCR2019_0206,within-group subordinate,within-group subordinate,229,206,23,20,9,226,215,1,99999,8194,8156,8127,0.112232490272374,0,0,NA,NA,none,hothiphop.parents,hot.parents
2019,1,WCR2019_1749,3,WCR2019_0399,WCR2019_0206,within-group subordinate,within-group subordinate,234,209,25,22,9,231,218,1,99999,8207,8156,8139,0.112232490272374,0,0,NA,NA,none,hothiphop.parents,hot.parents
2019,1,WCR2019_1750,1,WCR2019_0493,WCR2019_0327,within-group subordinate,within-group subordinate,147,132,15,2,13,134,145,1,99999,8168,8057,8019,0.120248538011696,0,0,NA,NA,none,hothiphop.parents,hot.parents
2019,1,WCR2019_1750,2,WCR2019_0493,WCR2019_0641,within-group subordinate,within-group subordinate,155,126,29,2,28,128,154,1,99999,8168,6057,6030,0.120248538011696,0,0,NA,NA,none,hothiphop.parents,hot.parents
2019,1,WCR2019_1750,3,WCR2019_0493,WCR2019_0075,within-group subordinate,within-group subordinate,161,144,17,2,15,146,159,1,99999,8168,7679,7643,0.120248538011696,0,0,NA,NA,none,hothiphop.parents,hot.parents
2019,1,WCR2019_1751,1,WCR2019_0440,WCR2019_0161,within-group subordinate,within-group subordinate,310,265,45,36,20,301,285,1,99999,6831,8092,6725,0.10726012404232,0,0,NA,NA,none,hothiphop.parents,hot.parents
2019,1,WCR2019_1751,2,WCR2019_0223,WCR2019_0161,within-group subordinate,within-group subordinate,311,262,49,44,20,306,282,1,99999,5963,8092,5870,0.10726012404232,0,0,NA,NA,none,hothiphop.parents,hot.parents
2019,1,WCR2019_1751,3,WCR2019_0223,WCR2019_0641,within-group subordinate,within-group subordinate,313,245,68,44,76,289,321,1,99999,5963,6071,4481,0.10726012404232,0,0,NA,NA,none,hothiphop.parents,hot.parents
2019,1,WCR2019_1752,1,WCR2019_0420,WCR2019_0325,within-group subordinate,within-group subordinate,7,2,5,2,3,4,5,1,99999,8211,8181,8168,0.0441230096025283,0,0,NA,NA,none,hothiphop.parents,hot.parents
2019,1,WCR2019_1752,2,WCR2019_0474,WCR2019_0325,within-group subordinate,within-group subordinate,48,35,13,11,3,46,38,1,99999,7906,8181,7862,0.0441230096025283,0,0,NA,NA,none,hothiphop.parents,hot.parents
2019,1,WCR2019_1752,3,WCR2019_0064,WCR2019_0325,within-group subordinate,within-group subordinate,54,37,17,15,3,52,40,1,99999,7191,8181,7149,0.0441230096025283,0,0,NA,NA,none,hothiphop.parents,hot.parents
2019,1,WCR2019_1753,1,WCR2019_0223,WCR2019_0641,within-group subordinate,within-group subordinate,252,216,36,28,36,244,252,1,99999,6020,6121,4523,0.14447660395562,0,0,NA,NA,none,hothiphop.parents,hot.parents
2019,1,WCR2019_1753,2,WCR2019_0223,WCR2019_0088,within-group subordinate,within-group subordinate,267,225,42,28,44,253,269,1,99999,6020,7328,5302,0.14447660395562,0,0,NA,NA,none,hothiphop.parents,hot.parents
2019,1,WCR2019_1753,3,WCR2019_0223,WCR2019_0327,within-group subordinate,within-group subordinate,284,250,34,28,18,278,268,1,99999,6020,8141,5934,0.14447660395562,0,0,NA,NA,none,hothiphop.parents,hot.parents
2019,1,WCR2019_1754,1,WCR2019_0409,WCR2019_0088,within-group subordinate,within-group subordinate,62,47,15,8,8,55,55,1,99999,7522,6723,6696,0.0198675496688742,0,0,NA,NA,none,hothiphop.parents,hot.parents
2019,1,WCR2019_1754,2,WCR2019_0064,WCR2019_0088,within-group subordinate,within-group subordinate,63,48,15,10,8,58,56,1,99999,6674,6723,6139,0.0198675496688742,0,0,NA,NA,none,hothiphop.parents,hot.parents
2019,1,WCR2019_1754,3,WCR2019_0318,WCR2019_0388,within-group subordinate,within-group subordinate,63,45,18,4,14,49,59,1,99999,7524,7530,7504,0.0198675496688742,0,0,NA,NA,none,hothiphop.parents,hot.parents
2019,1,WCR2019_1755,1,WCR2019_0223,WCR2019_0279,within-group subordinate,within-group subordinate,333,268,65,48,34,316,302,1,99999,6051,8241,5996,0.106533749699736,0,0,NA,NA,none,hothiphop.parents,hot.parents
2019,1,WCR2019_1755,2,WCR2019_0223,WCR2019_0641,within-group subordinate,within-group subordinate,348,278,70,48,69,326,347,1,99999,6051,6138,4542,0.106533749699736,0,0,NA,NA,none,hothiphop.parents,hot.parents
2019,1,WCR2019_1755,3,WCR2019_0440,WCR2019_0279,within-group subordinate,within-group subordinate,358,296,62,39,34,335,330,1,99999,6921,8241,6858,0.106533749699736,0,0,NA,NA,none,hothiphop.parents,hot.parents
2019,1,WCR2019_1756,1,WCR2019_0223,WCR2019_0641,within-group subordinate,within-group subordinate,292,228,64,46,66,274,294,1,99999,5956,6052,4478,0.0987910611796312,0,0,NA,NA,none,hothiphop.parents,hot.parents
2019,1,WCR2019_1756,2,WCR2019_0223,WCR2019_0087,within-group subordinate,within-group subordinate,314,258,56,46,48,304,306,1,99999,5956,7160,5185,0.0987910611796312,0,0,NA,NA,none,hothiphop.parents,hot.parents
2019,1,WCR2019_1756,3,WCR2019_0223,WCR2019_0327,within-group subordinate,within-group subordinate,326,277,49,46,30,323,307,1,99999,5956,8045,5874,0.0987910611796312,0,0,NA,NA,none,hothiphop.parents,hot.parents
2019,1,WCR2019_1757,1,WCR2019_0223,WCR2019_0641,within-group subordinate,within-group subordinate,255,205,50,45,44,250,249,1,99999,6026,6127,4526,0.140568537701759,0,0,NA,NA,none,hothiphop.parents,hot.parents
2019,1,WCR2019_1757,2,WCR2019_0223,WCR2019_0075,within-group subordinate,within-group subordinate,280,239,41,45,27,284,266,1,99999,6026,7763,5598,0.140568537701759,0,0,NA,NA,none,hothiphop.parents,hot.parents
2019,1,WCR2019_1757,3,WCR2019_0223,WCR2019_0088,within-group subordinate,within-group subordinate,296,236,60,45,50,281,286,1,99999,6026,7340,5313,0.140568537701759,0,0,NA,NA,none,hothiphop.parents,hot.parents
2019,1,WCR2019_1758,1,WCR2019_0474,WCR2019_0405,within-group subordinate,within-group subordinate,56,47,9,11,0,58,47,1,99999,7930,8093,7786,0.0253241245607658,0,0,NA,NA,none,hothiphop.parents,hot.parents
2019,1,WCR2019_1758,2,WCR2019_0260,WCR2019_0405,within-group subordinate,within-group subordinate,60,51,9,13,0,64,51,1,99999,8167,8093,8011,0.0253241245607658,0,0,NA,NA,none,hothiphop.parents,hot.parents
2019,1,WCR2019_1758,3,WCR2019_0489,WCR2019_0405,within-group subordinate,within-group subordinate,60,46,14,15,0,61,46,1,99999,8221,8093,8061,0.0253241245607658,0,0,NA,NA,none,hothiphop.parents,hot.parents
2019,1,WCR2019_1759,1,WCR2019_0223,WCR2019_0641,within-group subordinate,within-group subordinate,260,199,61,39,72,238,271,1,99999,5797,5903,4356,0.104427213606803,0,0,NA,NA,none,hothiphop.parents,hot.parents
2019,1,WCR2019_1759,2,WCR2019_0223,WCR2019_0327,within-group subordinate,within-group subordinate,284,242,42,39,21,281,263,1,99999,5797,7847,5712,0.104427213606803,0,0,NA,NA,none,hothiphop.parents,hot.parents
2019,1,WCR2019_1759,3,WCR2019_0223,WCR2019_0161,within-group subordinate,within-group subordinate,285,240,45,39,32,279,272,1,99999,5797,7867,5705,0.104427213606803,0,0,NA,NA,none,hothiphop.parents,hot.parents
2019,1,WCR2019_1760,1,WCR2019_0008,WCR2019_0079,within-group subordinate,within-group subordinate,215,175,40,40,4,215,179,1,99999,8112,8224,8087,0.109104133834404,0,0,NA,NA,none,hothiphop.parents,hot.parents
2019,1,WCR2019_1760,2,WCR2019_0441,WCR2019_0079,within-group subordinate,within-group subordinate,223,181,42,41,4,222,185,1,99999,8227,8224,8202,0.109104133834404,0,0,NA,NA,none,hothiphop.parents,hot.parents
2019,1,WCR2019_1760,3,WCR2019_0267,WCR2019_0079,within-group subordinate,within-group subordinate,223,178,45,43,4,221,182,1,99999,8188,8224,8163,0.109104133834404,0,0,NA,NA,none,hothiphop.parents,hot.parents
2019,1,WCR2019_1761,1,WCR2019_0223,WCR2019_0641,within-group subordinate,within-group subordinate,328,257,71,46,74,303,331,1,99999,5987,6088,4491,0.0887057682985943,0,0,NA,NA,none,hothiphop.parents,hot.parents
2019,1,WCR2019_1761,2,WCR2019_0223,WCR2019_0087,within-group subordinate,within-group subordinate,348,283,65,46,66,329,349,1,99999,5987,7209,5204,0.0887057682985943,0,0,NA,NA,none,hothiphop.parents,hot.parents
2019,1,WCR2019_1761,3,WCR2019_0126,WCR2019_0641,within-group subordinate,within-group subordinate,360,227,133,145,74,372,301,1,99999,5235,6088,3905,0.0887057682985943,0,0,NA,NA,none,hothiphop.parents,hot.parents
2019,1,WCR2019_1762,1,WCR2019_0223,WCR2019_0641,within-group subordinate,within-group subordinate,223,171,52,53,23,224,194,1,99999,5957,6053,4471,0.148197759376522,0,0,NA,NA,none,hothiphop.parents,hot.parents
2019,1,WCR2019_1762,2,WCR2019_0008,WCR2019_0641,within-group subordinate,within-group subordinate,228,203,25,6,23,209,226,1,99999,8080,6053,5970,0.148197759376522,0,0,NA,NA,none,hothiphop.parents,hot.parents
2019,1,WCR2019_1762,3,WCR2019_0196,WCR2019_0641,within-group subordinate,within-group subordinate,229,203,26,8,23,211,226,1,99999,8154,6053,6012,0.148197759376522,0,0,NA,NA,none,hothiphop.parents,hot.parents
2019,1,WCR2019_1763,1,WCR2019_0223,WCR2019_0641,within-group subordinate,within-group subordinate,319,255,64,36,71,291,326,1,99999,6024,6128,4523,0.124684077506318,0,0,NA,NA,none,hothiphop.parents,hot.parents
2019,1,WCR2019_1763,2,WCR2019_0223,WCR2019_0327,within-group subordinate,within-group subordinate,338,295,43,36,27,331,322,1,99999,6024,8158,5938,0.124684077506318,0,0,NA,NA,none,hothiphop.parents,hot.parents
2019,1,WCR2019_1763,3,WCR2019_0223,WCR2019_0075,within-group subordinate,within-group subordinate,360,299,61,36,59,335,358,1,99999,6024,7767,5595,0.124684077506318,0,0,NA,NA,none,hothiphop.parents,hot.parents
2019,1,WCR2019_1764,1,WCR2019_0532,WCR2019_0327,within-group subordinate,within-group subordinate,273,249,24,4,24,253,273,1,99999,8268,8183,8120,0.0961123110151188,0,0,NA,NA,none,hothiphop.parents,hot.parents
2019,1,WCR2019_1764,2,WCR2019_0532,WCR2019_0087,within-group subordinate,within-group subordinate,290,244,46,4,45,248,289,1,99999,8268,7276,7216,0.0961123110151188,0,0,NA,NA,none,hothiphop.parents,hot.parents
2019,1,WCR2019_1764,3,WCR2019_0532,WCR2019_0641,within-group subordinate,within-group subordinate,303,216,87,4,87,220,303,1,99999,8268,6147,6094,0.0961123110151188,0,0,NA,NA,none,hothiphop.parents,hot.parents
2019,1,WCR2019_1765,1,WCR2019_0585,WCR2019_0122,within-group subordinate,within-group subordinate,278,226,52,5,48,231,274,1,99999,8285,8245,8219,0.0909637829382746,0,0,NA,NA,none,hothiphop.parents,hot.parents
2019,1,WCR2019_1765,2,WCR2019_0585,WCR2019_0327,within-group subordinate,within-group subordinate,284,248,36,5,32,253,280,1,99999,8285,8161,8136,0.0909637829382746,0,0,NA,NA,none,hothiphop.parents,hot.parents
2019,1,WCR2019_1765,3,WCR2019_0585,WCR2019_0161,within-group subordinate,within-group subordinate,287,237,50,5,45,242,282,1,99999,8285,8177,8151,0.0909637829382746,0,0,NA,NA,none,hothiphop.parents,hot.parents
2019,1,WCR2019_1766,1,WCR2019_0280,WCR2019_0286,within-group subordinate,within-group subordinate,14,7,7,3,4,10,11,1,99999,8076,8106,8024,0.112513788454467,0,0,NA,NA,none,hothiphop.parents,hot.parents
2019,1,WCR2019_1766,2,WCR2019_0280,WCR2019_0122,within-group subordinate,within-group subordinate,160,135,25,3,23,138,158,1,99999,8076,8093,8011,0.112513788454467,0,0,NA,NA,none,hothiphop.parents,hot.parents
2019,1,WCR2019_1766,3,WCR2019_0280,WCR2019_0327,within-group subordinate,within-group subordinate,168,148,20,3,17,151,165,1,99999,8076,8014,7938,0.112513788454467,0,0,NA,NA,none,hothiphop.parents,hot.parents
2019,1,WCR2019_1767,1,WCR2019_0223,WCR2019_0087,within-group subordinate,within-group subordinate,342,285,57,48,38,333,323,1,99999,5960,7152,5182,0.0935401147881304,0,0,NA,NA,none,hothiphop.parents,hot.parents
2019,1,WCR2019_1767,2,WCR2019_0223,WCR2019_0641,within-group subordinate,within-group subordinate,344,265,79,48,83,313,348,1,99999,5960,6050,4478,0.0935401147881304,0,0,NA,NA,none,hothiphop.parents,hot.parents
2019,1,WCR2019_1767,3,WCR2019_0223,WCR2019_0073,within-group subordinate,within-group subordinate,357,296,61,48,37,344,333,1,99999,5960,7803,5646,0.0935401147881304,0,0,NA,NA,none,hothiphop.parents,hot.parents
2019,1,WCR2019_1768,1,WCR2019_0473,WCR2019_0398,within-group subordinate,within-group subordinate,171,137,34,22,13,159,150,1,99999,8320,8319,8291,0.171418303785338,0,0,NA,NA,none,hothiphop.parents,hot.parents
2019,1,WCR2019_1768,2,WCR2019_0473,WCR2019_0039,within-group subordinate,within-group subordinate,186,162,24,22,3,184,165,1,99999,8320,8224,8196,0.171418303785338,0,0,NA,NA,none,hothiphop.parents,hot.parents
2019,1,WCR2019_1768,3,WCR2019_0473,WCR2019_0088,within-group subordinate,within-group subordinate,194,170,24,22,5,192,175,1,99999,8320,7377,7349,0.171418303785338,0,0,NA,NA,none,hothiphop.parents,hot.parents
2019,1,WCR2019_1769,1,WCR2019_0223,WCR2019_0641,within-group subordinate,within-group subordinate,250,192,58,42,54,234,246,1,99999,5464,5512,4121,0.093241972322988,0,0,NA,NA,none,hothiphop.parents,hot.parents
2019,1,WCR2019_1769,2,WCR2019_0223,WCR2019_0327,within-group subordinate,within-group subordinate,274,229,45,42,10,271,239,1,99999,5464,7304,5383,0.093241972322988,0,0,NA,NA,none,hothiphop.parents,hot.parents
2019,1,WCR2019_1769,3,WCR2019_0440,WCR2019_0641,within-group subordinate,within-group subordinate,281,220,61,31,54,251,274,1,99999,6267,5512,4686,0.093241972322988,0,0,NA,NA,none,hothiphop.parents,hot.parents
2019,1,WCR2019_1770,1,WCR2019_0566,WCR2019_0413,within-group subordinate,within-group subordinate,130,99,31,3,30,102,129,1,99999,8169,8166,8103,0.118318756073858,0,0,NA,NA,none,hothiphop.parents,hot.parents
2019,1,WCR2019_1770,2,WCR2019_0566,WCR2019_0124,within-group subordinate,within-group subordinate,159,118,41,3,39,121,157,1,99999,8169,8205,8142,0.118318756073858,0,0,NA,NA,none,hothiphop.parents,hot.parents
2019,1,WCR2019_1770,3,WCR2019_0566,WCR2019_0327,within-group subordinate,within-group subordinate,245,220,25,3,23,223,243,1,99999,8169,8082,8020,0.118318756073858,0,0,NA,NA,none,hothiphop.parents,hot.parents
2019,1,WCR2019_1771,1,WCR2019_0008,WCR2019_0206,within-group subordinate,within-group subordinate,129,107,22,19,3,126,110,1,99999,8040,8105,7977,0.0925336597307222,0,0,NA,NA,none,hothiphop.parents,hot.parents
2019,1,WCR2019_1771,2,WCR2019_0441,WCR2019_0206,within-group subordinate,within-group subordinate,138,116,22,19,3,135,119,1,99999,8147,8105,8083,0.0925336597307222,0,0,NA,NA,none,hothiphop.parents,hot.parents
2019,1,WCR2019_1771,3,WCR2019_0141,WCR2019_0206,within-group subordinate,within-group subordinate,140,111,29,26,3,137,114,1,99999,8155,8105,8090,0.0925336597307222,0,0,NA,NA,none,hothiphop.parents,hot.parents
2019,1,WCR2019_1773,1,WCR2019_0522,WCR2019_0641,within-group subordinate,within-group subordinate,212,173,39,6,36,179,209,1,99999,7772,5740,5724,0.120733897870157,0,0,NA,NA,none,hothiphop.parents,hot.parents
2019,1,WCR2019_1773,2,WCR2019_0223,WCR2019_0641,within-group subordinate,within-group subordinate,213,173,40,29,36,202,209,1,99999,5719,5740,4292,0.120733897870157,0,0,NA,NA,none,hothiphop.parents,hot.parents
2019,1,WCR2019_1773,3,WCR2019_0522,WCR2019_0122,within-group subordinate,within-group subordinate,224,207,17,6,12,213,219,1,99999,7772,7733,7712,0.120733897870157,0,0,NA,NA,none,hothiphop.parents,hot.parents
2019,1,WCR2019_1774,1,WCR2019_0361,WCR2019_0109,within-group subordinate,within-group subordinate,135,113,22,4,19,117,132,1,99999,7569,7809,7442,0.139529026570961,0,0,NA,NA,none,hothiphop.parents,hot.parents
2019,1,WCR2019_1774,2,WCR2019_0462,WCR2019_0331,within-group subordinate,within-group subordinate,199,158,41,34,8,192,166,1,99999,7896,7912,7868,0.139529026570961,0,0,NA,NA,none,hothiphop.parents,hot.parents
2019,1,WCR2019_1774,3,WCR2019_0223,WCR2019_0331,within-group subordinate,within-group subordinate,209,172,37,33,8,205,180,1,99999,5760,7912,5743,0.139529026570961,0,0,NA,NA,none,hothiphop.parents,hot.parents
2019,1,WCR2019_1775,1,WCR2019_0223,WCR2019_0153,within-group subordinate,within-group subordinate,265,210,55,51,8,261,218,1,99999,6025,8266,5995,0.0991207997109479,0,0,NA,NA,none,hothiphop.parents,hot.parents
2019,1,WCR2019_1775,2,WCR2019_0008,WCR2019_0153,within-group subordinate,within-group subordinate,304,257,47,42,8,299,265,1,99999,8167,8266,8131,0.0991207997109479,0,0,NA,NA,none,hothiphop.parents,hot.parents
2019,1,WCR2019_1775,3,WCR2019_0076,WCR2019_0153,within-group subordinate,within-group subordinate,311,259,52,46,8,305,267,1,99999,7144,8266,7117,0.0991207997109479,0,0,NA,NA,none,hothiphop.parents,hot.parents
2019,1,WCR2019_1776,1,WCR2019_0223,WCR2019_0641,within-group subordinate,within-group subordinate,345,266,79,49,85,315,351,1,99999,6026,6122,4528,0.0969375452134073,0,0,NA,NA,none,hothiphop.parents,hot.parents
2019,1,WCR2019_1776,2,WCR2019_0223,WCR2019_0161,within-group subordinate,within-group subordinate,366,304,62,49,44,353,348,1,99999,6026,8163,5932,0.0969375452134073,0,0,NA,NA,none,hothiphop.parents,hot.parents
2019,1,WCR2019_1776,3,WCR2019_0223,WCR2019_0639,within-group subordinate,within-group subordinate,369,298,71,49,47,347,345,1,99999,6026,8254,6002,0.0969375452134073,0,0,NA,NA,none,hothiphop.parents,hot.parents
2019,1,WCR2019_1777,1,WCR2019_0394,WCR2019_0327,within-group subordinate,within-group subordinate,186,165,21,9,15,174,180,1,99999,8215,8104,8069,0.13525633256575,0,0,NA,NA,none,hothiphop.parents,hot.parents
2019,1,WCR2019_1777,2,WCR2019_0394,WCR2019_0641,within-group subordinate,within-group subordinate,193,147,46,9,43,156,190,1,99999,8215,6085,6055,0.13525633256575,0,0,NA,NA,none,hothiphop.parents,hot.parents
2019,1,WCR2019_1777,3,WCR2019_0394,WCR2019_0122,within-group subordinate,within-group subordinate,195,166,29,9,23,175,189,1,99999,8215,8186,8150,0.13525633256575,0,0,NA,NA,none,hothiphop.parents,hot.parents
2019,1,WCR2019_1779,1,WCR2019_0476,WCR2019_0084,within-group subordinate,within-group subordinate,147,112,35,33,2,145,114,1,99999,8265,8269,8231,0.0961098398169336,0,0,NA,NA,none,hothiphop.parents,hot.parents
2019,1,WCR2019_1779,2,WCR2019_0223,WCR2019_0084,within-group subordinate,within-group subordinate,217,180,37,35,2,215,182,1,99999,6025,8269,5997,0.0961098398169336,0,0,NA,NA,none,hothiphop.parents,hot.parents
2019,1,WCR2019_1779,3,WCR2019_0440,WCR2019_0084,within-group subordinate,within-group subordinate,263,210,53,51,2,261,212,1,99999,6900,8269,6868,0.0961098398169336,0,0,NA,NA,none,hothiphop.parents,hot.parents
2019,1,WCR2019_1780,1,WCR2019_0566,WCR2019_0641,within-group subordinate,within-group subordinate,156,124,32,1,32,125,156,1,99999,8199,6096,6048,0.124909222948439,0,0,NA,NA,none,hothiphop.parents,hot.parents
2019,1,WCR2019_1780,2,WCR2019_0566,WCR2019_0327,within-group subordinate,within-group subordinate,178,164,14,1,14,165,178,1,99999,8199,8116,8054,0.124909222948439,0,0,NA,NA,none,hothiphop.parents,hot.parents
2019,1,WCR2019_1780,3,WCR2019_0566,WCR2019_0206,within-group subordinate,within-group subordinate,185,155,30,1,29,156,184,1,99999,8199,8194,8131,0.124909222948439,0,0,NA,NA,none,hothiphop.parents,hot.parents
2019,1,WCR2019_1781,1,WCR2019_0223,WCR2019_0641,within-group subordinate,within-group subordinate,312,226,86,51,92,277,318,1,99999,5983,6084,4493,0.0901152213462705,0,0,NA,NA,none,hothiphop.parents,hot.parents
2019,1,WCR2019_1781,2,WCR2019_0223,WCR2019_0087,within-group subordinate,within-group subordinate,322,253,69,51,55,304,308,1,99999,5983,7213,5207,0.0901152213462705,0,0,NA,NA,none,hothiphop.parents,hot.parents
2019,1,WCR2019_1781,3,WCR2019_0223,WCR2019_0327,within-group subordinate,within-group subordinate,324,270,54,51,31,321,301,1,99999,5983,8095,5897,0.0901152213462705,0,0,NA,NA,none,hothiphop.parents,hot.parents
2019,1,WCR2019_1782,1,WCR2019_0365,WCR2019_0475,within-group subordinate,within-group subordinate,235,201,34,3,32,204,233,1,99999,8097,8123,8072,0.105301914580265,0,0,NA,NA,none,hothiphop.parents,hot.parents
2019,1,WCR2019_1782,2,WCR2019_0365,WCR2019_0327,within-group subordinate,within-group subordinate,242,227,15,3,12,230,239,1,99999,8097,7999,7950,0.105301914580265,0,0,NA,NA,none,hothiphop.parents,hot.parents
2019,1,WCR2019_1782,3,WCR2019_0365,WCR2019_0161,within-group subordinate,within-group subordinate,266,225,41,3,39,228,264,1,99999,8097,8020,7970,0.105301914580265,0,0,NA,NA,none,hothiphop.parents,hot.parents
2019,1,WCR2019_1783,1,WCR2019_0223,WCR2019_0279,within-group subordinate,within-group subordinate,240,185,55,53,4,238,189,1,99999,5988,8183,5937,0.0949903194578896,0,0,NA,NA,none,hothiphop.parents,hot.parents
2019,1,WCR2019_1783,2,WCR2019_0008,WCR2019_0279,within-group subordinate,within-group subordinate,244,211,33,32,4,243,215,1,99999,8132,8183,8051,0.0949903194578896,0,0,NA,NA,none,hothiphop.parents,hot.parents
2019,1,WCR2019_1783,3,WCR2019_0440,WCR2019_0279,within-group subordinate,within-group subordinate,253,198,55,54,4,252,202,1,99999,6868,8183,6809,0.0949903194578896,0,0,NA,NA,none,hothiphop.parents,hot.parents
2019,1,WCR2019_1784,1,WCR2019_0282,WCR2019_0088,within-group subordinate,within-group subordinate,193,179,14,13,5,192,184,1,99999,8137,7290,7201,0.104227405247813,0,0,NA,NA,none,hothiphop.parents,hot.parents
2019,1,WCR2019_1784,2,WCR2019_0531,WCR2019_0088,within-group subordinate,within-group subordinate,194,186,8,7,5,193,191,1,99999,8203,7290,7263,0.104227405247813,0,0,NA,NA,none,hothiphop.parents,hot.parents
2019,1,WCR2019_1784,3,WCR2019_0318,WCR2019_0088,within-group subordinate,within-group subordinate,198,186,12,10,5,196,191,1,99999,8206,7290,7265,0.104227405247813,0,0,NA,NA,none,hothiphop.parents,hot.parents
2019,1,WCR2019_1785,1,WCR2019_0223,WCR2019_0641,within-group subordinate,within-group subordinate,234,188,46,28,43,216,231,1,99999,5992,6089,4503,0.140380652200267,0,0,NA,NA,none,hothiphop.parents,hot.parents
2019,1,WCR2019_1785,2,WCR2019_0223,WCR2019_0327,within-group subordinate,within-group subordinate,241,210,31,28,8,238,218,1,99999,5992,8100,5907,0.140380652200267,0,0,NA,NA,none,hothiphop.parents,hot.parents
2019,1,WCR2019_1785,3,WCR2019_0462,WCR2019_0327,within-group subordinate,within-group subordinate,263,218,45,41,8,259,226,1,99999,8203,8100,8055,0.140380652200267,0,0,NA,NA,none,hothiphop.parents,hot.parents
2019,1,WCR2019_1786,1,WCR2019_0534,WCR2019_0066,within-group subordinate,within-group subordinate,84,70,14,10,4,80,74,1,99999,8240,8225,8194,0.119937129730383,0,0,NA,NA,none,hothiphop.parents,hot.parents
2019,1,WCR2019_1786,2,WCR2019_0008,WCR2019_0066,within-group subordinate,within-group subordinate,192,166,26,23,4,189,170,1,99999,8135,8225,8090,0.119937129730383,0,0,NA,NA,none,hothiphop.parents,hot.parents
2019,1,WCR2019_1786,3,WCR2019_0196,WCR2019_0066,within-group subordinate,within-group subordinate,209,177,32,29,4,206,181,1,99999,8213,8225,8167,0.119937129730383,0,0,NA,NA,none,hothiphop.parents,hot.parents
2019,1,WCR2019_1787,1,WCR2019_0559,WCR2019_0539,within-group subordinate,within-group subordinate,18,10,8,4,4,14,14,1,99999,8215,8231,8181,0.128493647912886,0,0,NA,NA,none,hothiphop.parents,hot.parents
2019,1,WCR2019_1787,2,WCR2019_0256,WCR2019_0539,within-group subordinate,within-group subordinate,152,136,16,12,4,148,140,1,99999,8206,8231,8172,0.128493647912886,0,0,NA,NA,none,hothiphop.parents,hot.parents
2019,1,WCR2019_1787,3,WCR2019_0008,WCR2019_0539,within-group subordinate,within-group subordinate,153,134,19,16,4,150,138,1,99999,8131,8231,8099,0.128493647912886,0,0,NA,NA,none,hothiphop.parents,hot.parents
2019,1,WCR2019_1788,1,WCR2019_0395,WCR2019_0327,within-group subordinate,within-group subordinate,213,180,33,5,29,185,209,1,99999,8318,8209,8169,0.115444431152052,0,0,NA,NA,none,hothiphop.parents,hot.parents
2019,1,WCR2019_1788,2,WCR2019_0395,WCR2019_0075,within-group subordinate,within-group subordinate,226,178,48,5,45,183,223,1,99999,8318,7813,7775,0.115444431152052,0,0,NA,NA,none,hothiphop.parents,hot.parents
2019,1,WCR2019_1788,3,WCR2019_0395,WCR2019_0039,within-group subordinate,within-group subordinate,238,196,42,5,40,201,236,1,99999,8318,8234,8193,0.115444431152052,0,0,NA,NA,none,hothiphop.parents,hot.parents
2019,1,WCR2019_1789,1,WCR2019_0219,WCR2019_0641,within-group subordinate,within-group subordinate,362,260,102,34,90,294,350,1,99999,7546,6142,5597,0.092972972972973,0,0,NA,NA,none,hothiphop.parents,hot.parents
2019,1,WCR2019_1789,2,WCR2019_0219,WCR2019_0204,within-group subordinate,within-group subordinate,367,300,67,34,46,334,346,1,99999,7546,8307,7531,0.092972972972973,0,0,NA,NA,none,hothiphop.parents,hot.parents
2019,1,WCR2019_1789,3,WCR2019_0219,WCR2019_0087,within-group subordinate,within-group subordinate,368,310,58,34,48,344,358,1,99999,7546,7275,6568,0.092972972972973,0,0,NA,NA,none,hothiphop.parents,hot.parents
2019,1,WCR2019_1790,1,WCR2019_0223,WCR2019_0641,within-group subordinate,within-group subordinate,301,247,54,38,50,285,297,1,99999,6061,6163,4549,0.137130549240158,0,0,NA,NA,none,hothiphop.parents,hot.parents
2019,1,WCR2019_1790,2,WCR2019_0223,WCR2019_0088,within-group subordinate,within-group subordinate,307,241,66,38,62,279,303,1,99999,6061,7383,5339,0.137130549240158,0,0,NA,NA,none,hothiphop.parents,hot.parents
2019,1,WCR2019_1790,3,WCR2019_0223,WCR2019_0327,within-group subordinate,within-group subordinate,310,268,42,38,18,306,286,1,99999,6061,8206,5975,0.137130549240158,0,0,NA,NA,none,hothiphop.parents,hot.parents
2019,1,WCR2019_1792,1,WCR2019_0223,WCR2019_0641,within-group subordinate,within-group subordinate,298,215,83,44,83,259,298,1,99999,5901,5989,4436,0.092320966350302,0,0,NA,NA,none,hothiphop.parents,hot.parents
2019,1,WCR2019_1792,2,WCR2019_0223,WCR2019_0087,within-group subordinate,within-group subordinate,310,249,61,44,46,293,295,1,99999,5901,7112,5146,0.092320966350302,0,0,NA,NA,none,hothiphop.parents,hot.parents
2019,1,WCR2019_1792,3,WCR2019_0223,WCR2019_0161,within-group subordinate,within-group subordinate,320,263,57,44,40,307,303,1,99999,5901,7987,5812,0.092320966350302,0,0,NA,NA,none,hothiphop.parents,hot.parents
2019,1,WCR2019_1793,1,WCR2019_0496,WCR2019_0641,within-group subordinate,within-group subordinate,213,161,52,3,50,164,211,1,99999,8169,6046,6021,0.109039961013645,0,0,NA,NA,none,hothiphop.parents,hot.parents
2019,1,WCR2019_1793,2,WCR2019_0496,WCR2019_0122,within-group subordinate,within-group subordinate,219,191,28,3,25,194,216,1,99999,8169,8144,8105,0.109039961013645,0,0,NA,NA,none,hothiphop.parents,hot.parents
2019,1,WCR2019_1793,3,WCR2019_0496,WCR2019_0327,within-group subordinate,within-group subordinate,221,198,23,3,20,201,218,1,99999,8169,8059,8021,0.109039961013645,0,0,NA,NA,none,hothiphop.parents,hot.parents
2019,1,WCR2019_1794,1,WCR2019_0223,WCR2019_0641,within-group subordinate,within-group subordinate,332,249,83,53,96,302,345,1,99999,5920,6031,4455,0.0897954183510964,0,0,NA,NA,none,hothiphop.parents,hot.parents
2019,1,WCR2019_1794,2,WCR2019_0223,WCR2019_0327,within-group subordinate,within-group subordinate,348,293,55,53,25,346,318,1,99999,5920,8013,5834,0.0897954183510964,0,0,NA,NA,none,hothiphop.parents,hot.parents
2019,1,WCR2019_1794,3,WCR2019_0223,WCR2019_0087,within-group subordinate,within-group subordinate,355,285,70,53,60,338,345,1,99999,5920,7158,5165,0.0897954183510964,0,0,NA,NA,none,hothiphop.parents,hot.parents
2019,1,WCR2019_1795,1,WCR2019_0223,WCR2019_0641,within-group subordinate,within-group subordinate,203,171,32,31,8,202,179,1,99999,6024,6131,4523,0.16893273974251,0,0,NA,NA,none,hothiphop.parents,hot.parents
2019,1,WCR2019_1795,2,WCR2019_0008,WCR2019_0641,within-group subordinate,within-group subordinate,225,214,11,6,8,220,222,1,99999,8174,6131,6044,0.16893273974251,0,0,NA,NA,none,hothiphop.parents,hot.parents
2019,1,WCR2019_1795,3,WCR2019_0223,WCR2019_0088,within-group subordinate,within-group subordinate,233,208,25,31,2,239,210,1,99999,6024,7345,5309,0.16893273974251,0,0,NA,NA,none,hothiphop.parents,hot.parents
2019,1,WCR2019_1796,1,WCR2019_0543,WCR2019_0327,within-group subordinate,within-group subordinate,250,222,28,6,23,228,245,1,99999,8100,8014,7957,0.0972800784121539,0,0,NA,NA,none,hothiphop.parents,hot.parents
2019,1,WCR2019_1796,2,WCR2019_0543,WCR2019_0161,within-group subordinate,within-group subordinate,267,229,38,6,33,235,262,1,99999,8100,8036,7974,0.0972800784121539,0,0,NA,NA,none,hothiphop.parents,hot.parents
2019,1,WCR2019_1796,3,WCR2019_0543,WCR2019_0641,within-group subordinate,within-group subordinate,273,189,84,6,80,195,269,1,99999,8100,6022,5979,0.0972800784121539,0,0,NA,NA,none,hothiphop.parents,hot.parents
2019,1,WCR2019_1797,1,WCR2019_0223,WCR2019_0641,within-group subordinate,within-group subordinate,287,233,54,34,64,267,297,1,99999,5985,6085,4491,0.112672643566756,0,0,NA,NA,none,hothiphop.parents,hot.parents
2019,1,WCR2019_1797,2,WCR2019_0223,WCR2019_0161,within-group subordinate,within-group subordinate,328,284,44,34,31,318,315,1,99999,5985,8123,5892,0.112672643566756,0,0,NA,NA,none,hothiphop.parents,hot.parents
2019,1,WCR2019_1797,3,WCR2019_0126,WCR2019_0641,within-group subordinate,within-group subordinate,331,212,119,125,64,337,276,1,99999,5240,6085,3906,0.112672643566756,0,0,NA,NA,none,hothiphop.parents,hot.parents
2019,1,WCR2019_1798,1,WCR2019_0223,WCR2019_0641,within-group subordinate,within-group subordinate,183,162,21,20,17,182,179,1,99999,5977,6060,4481,0.153621779290228,0,0,NA,NA,none,hothiphop.parents,hot.parents
2019,1,WCR2019_1798,2,WCR2019_0223,WCR2019_0327,within-group subordinate,within-group subordinate,229,205,24,20,9,225,214,1,99999,5977,8082,5892,0.153621779290228,0,0,NA,NA,none,hothiphop.parents,hot.parents
2019,1,WCR2019_1798,3,WCR2019_0223,WCR2019_0088,within-group subordinate,within-group subordinate,230,199,31,20,24,219,223,1,99999,5977,7282,5275,0.153621779290228,0,0,NA,NA,none,hothiphop.parents,hot.parents
2019,1,WCR2019_1799,1,WCR2019_0223,WCR2019_0641,within-group subordinate,within-group subordinate,199,178,21,28,14,206,192,1,99999,6044,6153,4544,0.159846393855754,0,0,NA,NA,none,hothiphop.parents,hot.parents
2019,1,WCR2019_1799,2,WCR2019_0223,WCR2019_0161,within-group subordinate,within-group subordinate,236,211,25,28,1,239,212,1,99999,6044,8200,5950,0.159846393855754,0,0,NA,NA,none,hothiphop.parents,hot.parents
2019,1,WCR2019_1799,3,WCR2019_0223,WCR2019_0088,within-group subordinate,within-group subordinate,238,210,28,28,8,238,218,1,99999,6044,7371,5333,0.159846393855754,0,0,NA,NA,none,hothiphop.parents,hot.parents
2019,1,WCR2019_1800,1,WCR2019_0223,WCR2019_0641,within-group subordinate,within-group subordinate,326,256,70,43,89,299,345,1,99999,6047,6148,4539,0.113030957523398,0,0,NA,NA,none,hothiphop.parents,hot.parents
2019,1,WCR2019_1800,2,WCR2019_0223,WCR2019_0327,within-group subordinate,within-group subordinate,342,293,49,43,30,336,323,1,99999,6047,8184,5962,0.113030957523398,0,0,NA,NA,none,hothiphop.parents,hot.parents
2019,1,WCR2019_1800,3,WCR2019_0223,WCR2019_0075,within-group subordinate,within-group subordinate,366,301,65,43,66,344,367,1,99999,6047,7792,5618,0.113030957523398,0,0,NA,NA,none,hothiphop.parents,hot.parents
2019,1,WCR2019_1801,1,WCR2019_0223,WCR2019_0641,within-group subordinate,within-group subordinate,311,249,62,43,65,292,314,1,99999,6053,6148,4544,0.10943124550036,0,0,NA,NA,none,hothiphop.parents,hot.parents
2019,1,WCR2019_1801,2,WCR2019_0223,WCR2019_0087,within-group subordinate,within-group subordinate,353,296,57,43,47,339,343,1,99999,6053,7284,5263,0.10943124550036,0,0,NA,NA,none,hothiphop.parents,hot.parents
2019,1,WCR2019_1801,3,WCR2019_0223,WCR2019_0327,within-group subordinate,within-group subordinate,355,307,48,43,27,350,334,1,99999,6053,8183,5967,0.10943124550036,0,0,NA,NA,none,hothiphop.parents,hot.parents
