year,brood,offspring,rank,dam,sire,dam.type,sire.type,hothiphop.parents,hiphop,hot.parents,hot.dam,hot.sire,hothiphop.dam,hothiphop.sire,below.threshold,threshold,loci.dyad.dam,loci.dyad.sire,loci.triad,offspring.heterozygosity,social.mother.sampled,social.father.sampled,social.mother,social.father,condition,ranking,ranking2
2019,1,WCR2019_0646,1,WCR2019_0267,WCR2019_0494,within-group subordinate,within-group subordinate,9,0,9,6,3,6,3,1,99999,845,854,840,0.429569266589057,0,0,NA,NA,none,hothiphop.parents,hot.parents
2019,1,WCR2019_0646,2,WCR2019_0119,WCR2019_0494,within-group subordinate,within-group subordinate,41,22,19,17,3,39,25,1,99999,858,854,853,0.429569266589057,0,0,NA,NA,none,hothiphop.parents,hot.parents
2019,1,WCR2019_0646,3,WCR2019_0256,WCR2019_0494,within-group subordinate,within-group subordinate,41,19,22,19,3,38,22,1,99999,856,854,851,0.429569266589057,0,0,NA,NA,none,hothiphop.parents,hot.parents
2019,1,WCR2019_0648,1,WCR2019_0223,WCR2019_0103,within-group subordinate,within-group subordinate,44,21,23,22,1,43,22,1,99999,418,725,416,0.389270976616231,0,0,NA,NA,none,hothiphop.parents,hot.parents
2019,1,WCR2019_0648,2,WCR2019_0440,WCR2019_0103,within-group subordinate,within-group subordinate,50,33,17,16,1,49,34,1,99999,483,725,481,0.389270976616231,0,0,NA,NA,none,hothiphop.parents,hot.parents
2019,1,WCR2019_0648,3,WCR2019_0223,WCR2019_0061,within-group subordinate,within-group subordinate,50,23,27,22,38,45,61,1,99999,418,637,359,0.389270976616231,0,0,NA,NA,none,hothiphop.parents,hot.parents
2019,1,WCR2019_0649,1,WCR2019_0223,WCR2019_0088,within-group subordinate,within-group subordinate,30,20,10,14,3,34,23,1,99999,487,646,381,0.472027972027972,0,0,NA,NA,none,hothiphop.parents,hot.parents
2019,1,WCR2019_0649,2,WCR2019_0223,WCR2019_0122,within-group subordinate,within-group subordinate,39,25,14,14,2,39,27,1,99999,487,846,480,0.472027972027972,0,0,NA,NA,none,hothiphop.parents,hot.parents
2019,1,WCR2019_0649,3,WCR2019_0223,WCR2019_0327,within-group subordinate,within-group subordinate,39,25,14,14,0,39,25,1,99999,487,827,472,0.472027972027972,0,0,NA,NA,none,hothiphop.parents,hot.parents
2019,1,WCR2019_0650,1,WCR2019_0223,WCR2019_0088,within-group subordinate,within-group subordinate,34,22,12,18,3,40,25,1,99999,488,645,381,0.490675990675991,0,0,NA,NA,none,hothiphop.parents,hot.parents
2019,1,WCR2019_0650,2,WCR2019_0440,WCR2019_0122,within-group subordinate,within-group subordinate,41,24,17,16,3,40,27,1,99999,567,846,561,0.490675990675991,0,0,NA,NA,none,hothiphop.parents,hot.parents
2019,1,WCR2019_0650,3,WCR2019_0223,WCR2019_0327,within-group subordinate,within-group subordinate,46,28,18,18,3,46,31,1,99999,488,827,473,0.490675990675991,0,0,NA,NA,none,hothiphop.parents,hot.parents
2019,1,WCR2019_0654,1,WCR2019_0223,WCR2019_0327,within-group subordinate,within-group subordinate,41,20,21,21,12,41,32,1,99999,486,826,471,0.43757292882147,0,0,NA,NA,none,hothiphop.parents,hot.parents
2019,1,WCR2019_0654,2,WCR2019_0223,WCR2019_0061,within-group subordinate,within-group subordinate,47,27,20,21,18,48,45,1,99999,486,760,424,0.43757292882147,0,0,NA,NA,none,hothiphop.parents,hot.parents
2019,1,WCR2019_0654,3,WCR2019_0223,WCR2019_0122,within-group subordinate,within-group subordinate,50,24,26,21,15,45,39,1,99999,486,845,479,0.43757292882147,0,0,NA,NA,none,hothiphop.parents,hot.parents
2019,1,WCR2019_0656,1,WCR2019_0223,WCR2019_0061,within-group subordinate,within-group subordinate,67,34,33,26,38,60,72,1,99999,488,761,425,0.383003492433062,0,0,NA,NA,none,hothiphop.parents,hot.parents
2019,1,WCR2019_0656,2,WCR2019_0223,WCR2019_0087,within-group subordinate,within-group subordinate,68,24,44,26,50,50,74,1,99999,488,626,355,0.383003492433062,0,0,NA,NA,none,hothiphop.parents,hot.parents
2019,1,WCR2019_0656,3,WCR2019_0223,WCR2019_0327,within-group subordinate,within-group subordinate,75,36,39,26,31,62,67,1,99999,488,828,473,0.383003492433062,0,0,NA,NA,none,hothiphop.parents,hot.parents
2019,1,WCR2019_0658,1,WCR2019_0223,WCR2019_0087,within-group subordinate,within-group subordinate,61,22,39,26,47,48,69,1,99999,488,627,356,0.377182770663562,0,0,NA,NA,none,hothiphop.parents,hot.parents
2019,1,WCR2019_0658,2,WCR2019_0223,WCR2019_0327,within-group subordinate,within-group subordinate,67,34,33,26,34,60,68,1,99999,488,828,473,0.377182770663562,0,0,NA,NA,none,hothiphop.parents,hot.parents
2019,1,WCR2019_0658,3,WCR2019_0223,WCR2019_0061,within-group subordinate,within-group subordinate,70,32,38,26,44,58,76,1,99999,488,762,426,0.377182770663562,0,0,NA,NA,none,hothiphop.parents,hot.parents
2019,1,WCR2019_0659,1,WCR2019_0223,WCR2019_0087,within-group subordinate,within-group subordinate,73,24,49,40,52,64,76,1,99999,489,624,356,0.344224037339557,0,0,NA,NA,none,hothiphop.parents,hot.parents
2019,1,WCR2019_0659,2,WCR2019_0440,WCR2019_0087,within-group subordinate,within-group subordinate,73,22,51,35,52,57,74,1,99999,569,624,414,0.344224037339557,0,0,NA,NA,none,hothiphop.parents,hot.parents
2019,1,WCR2019_0659,3,WCR2019_0440,WCR2019_0327,within-group subordinate,within-group subordinate,76,29,47,35,33,64,62,1,99999,569,826,549,0.344224037339557,0,0,NA,NA,none,hothiphop.parents,hot.parents
2019,1,WCR2019_0660,1,WCR2019_0223,WCR2019_0087,within-group subordinate,within-group subordinate,56,22,34,27,40,49,62,1,99999,487,625,354,0.421911421911422,0,0,NA,NA,none,hothiphop.parents,hot.parents
2019,1,WCR2019_0660,2,WCR2019_0223,WCR2019_0061,within-group subordinate,within-group subordinate,57,21,36,27,37,48,58,1,99999,487,761,425,0.421911421911422,0,0,NA,NA,none,hothiphop.parents,hot.parents
2019,1,WCR2019_0660,3,WCR2019_0440,WCR2019_0327,within-group subordinate,within-group subordinate,62,32,30,24,21,56,53,1,99999,568,827,548,0.421911421911422,0,0,NA,NA,none,hothiphop.parents,hot.parents
2019,1,WCR2019_0661,1,WCR2019_0440,WCR2019_0327,within-group subordinate,within-group subordinate,59,38,21,19,19,57,57,1,99999,568,828,548,0.39813736903376,0,0,NA,NA,none,hothiphop.parents,hot.parents
2019,1,WCR2019_0661,2,WCR2019_0440,WCR2019_0122,within-group subordinate,within-group subordinate,62,30,32,19,28,49,58,1,99999,568,847,562,0.39813736903376,0,0,NA,NA,none,hothiphop.parents,hot.parents
2019,1,WCR2019_0661,3,WCR2019_0440,WCR2019_0088,within-group subordinate,within-group subordinate,64,33,31,19,42,52,75,1,99999,568,646,432,0.39813736903376,0,0,NA,NA,none,hothiphop.parents,hot.parents
2019,1,WCR2019_0662,1,WCR2019_0223,WCR2019_0327,within-group subordinate,within-group subordinate,45,29,16,11,14,40,43,1,99999,488,827,473,0.407925407925408,0,0,NA,NA,none,hothiphop.parents,hot.parents
2019,1,WCR2019_0662,2,WCR2019_0223,WCR2019_0088,within-group subordinate,within-group subordinate,46,26,20,11,28,37,54,1,99999,488,645,380,0.407925407925408,0,0,NA,NA,none,hothiphop.parents,hot.parents
2019,1,WCR2019_0662,3,WCR2019_0223,WCR2019_0061,within-group subordinate,within-group subordinate,53,33,20,11,28,44,61,1,99999,488,760,425,0.407925407925408,0,0,NA,NA,none,hothiphop.parents,hot.parents
2019,1,WCR2019_0663,1,WCR2019_0223,WCR2019_0087,within-group subordinate,within-group subordinate,51,24,27,21,27,45,51,1,99999,486,625,355,0.483040935672515,0,0,NA,NA,none,hothiphop.parents,hot.parents
2019,1,WCR2019_0663,2,WCR2019_0223,WCR2019_0061,within-group subordinate,within-group subordinate,58,34,24,21,32,55,66,1,99999,486,759,424,0.483040935672515,0,0,NA,NA,none,hothiphop.parents,hot.parents
2019,1,WCR2019_0663,3,WCR2019_0223,WCR2019_0088,within-group subordinate,within-group subordinate,63,34,29,21,35,55,69,1,99999,486,644,380,0.483040935672515,0,0,NA,NA,none,hothiphop.parents,hot.parents
2019,1,WCR2019_0664,1,WCR2019_0532,WCR2019_0327,within-group subordinate,within-group subordinate,55,35,20,2,21,37,56,1,99999,846,826,815,0.364060676779463,0,0,NA,NA,none,hothiphop.parents,hot.parents
2019,1,WCR2019_0664,2,WCR2019_0223,WCR2019_0327,within-group subordinate,within-group subordinate,55,26,29,24,21,50,47,1,99999,488,826,473,0.364060676779463,0,0,NA,NA,none,hothiphop.parents,hot.parents
2019,1,WCR2019_0664,3,WCR2019_0223,WCR2019_0087,within-group subordinate,within-group subordinate,55,22,33,24,37,46,59,1,99999,488,626,356,0.364060676779463,0,0,NA,NA,none,hothiphop.parents,hot.parents
2019,1,WCR2019_0665,1,WCR2019_0223,WCR2019_0087,within-group subordinate,within-group subordinate,48,18,30,24,35,42,53,1,99999,440,564,316,0.406005221932115,0,0,NA,NA,none,hothiphop.parents,hot.parents
2019,1,WCR2019_0665,2,WCR2019_0223,WCR2019_0327,within-group subordinate,within-group subordinate,60,28,32,24,30,52,58,1,99999,440,737,425,0.406005221932115,0,0,NA,NA,none,hothiphop.parents,hot.parents
2019,1,WCR2019_0665,3,WCR2019_0223,WCR2019_0061,within-group subordinate,within-group subordinate,63,29,34,24,37,53,66,1,99999,440,682,385,0.406005221932115,0,0,NA,NA,none,hothiphop.parents,hot.parents
2019,1,WCR2019_0666,1,WCR2019_0565,WCR2019_0216,within-group subordinate,within-group subordinate,2,0,2,0,2,0,2,1,99999,853,853,847,0.374854481955763,0,0,NA,NA,none,hothiphop.parents,hot.parents
2019,1,WCR2019_0666,2,WCR2019_0223,WCR2019_0216,within-group subordinate,within-group subordinate,44,23,21,19,2,42,25,1,99999,488,853,487,0.374854481955763,0,0,NA,NA,none,hothiphop.parents,hot.parents
2019,1,WCR2019_0666,3,WCR2019_0223,WCR2019_0327,within-group subordinate,within-group subordinate,59,31,28,19,28,50,59,1,99999,488,828,473,0.374854481955763,0,0,NA,NA,none,hothiphop.parents,hot.parents
2019,1,WCR2019_0668,1,WCR2019_0223,WCR2019_0087,within-group subordinate,within-group subordinate,61,19,42,35,37,54,56,1,99999,488,625,356,0.35705950991832,0,0,NA,NA,none,hothiphop.parents,hot.parents
2019,1,WCR2019_0668,2,WCR2019_0585,WCR2019_0087,within-group subordinate,within-group subordinate,67,28,39,2,37,30,65,1,99999,857,625,625,0.35705950991832,0,0,NA,NA,none,hothiphop.parents,hot.parents
2019,1,WCR2019_0668,3,WCR2019_0440,WCR2019_0087,within-group subordinate,within-group subordinate,72,27,45,32,37,59,64,1,99999,566,625,412,0.35705950991832,0,0,NA,NA,none,hothiphop.parents,hot.parents
2019,1,WCR2019_0669,1,WCR2019_0223,WCR2019_0216,within-group subordinate,within-group subordinate,50,29,21,20,1,49,30,1,99999,455,778,454,0.40485312899106,0,0,NA,NA,none,hothiphop.parents,hot.parents
2019,1,WCR2019_0669,2,WCR2019_0223,WCR2019_0327,within-group subordinate,within-group subordinate,53,30,23,20,20,50,50,1,99999,455,755,441,0.40485312899106,0,0,NA,NA,none,hothiphop.parents,hot.parents
2019,1,WCR2019_0669,3,WCR2019_0223,WCR2019_0087,within-group subordinate,within-group subordinate,55,20,35,20,41,40,61,1,99999,455,567,336,0.40485312899106,0,0,NA,NA,none,hothiphop.parents,hot.parents
2019,1,WCR2019_0670,1,WCR2019_0076,WCR2019_0327,within-group subordinate,within-group subordinate,37,26,11,0,15,26,41,1,99999,591,794,569,0.354368932038835,0,0,NA,NA,none,hothiphop.parents,hot.parents
2019,1,WCR2019_0670,2,WCR2019_0076,WCR2019_0122,within-group subordinate,within-group subordinate,50,26,24,0,28,26,54,1,99999,591,812,581,0.354368932038835,0,0,NA,NA,none,hothiphop.parents,hot.parents
2019,1,WCR2019_0670,3,WCR2019_0223,WCR2019_0327,within-group subordinate,within-group subordinate,50,24,26,22,15,46,39,1,99999,472,794,458,0.354368932038835,0,0,NA,NA,none,hothiphop.parents,hot.parents
2019,1,WCR2019_0671,1,WCR2019_0223,WCR2019_0087,within-group subordinate,within-group subordinate,67,22,45,36,47,58,69,1,99999,489,627,356,0.37906976744186,0,0,NA,NA,none,hothiphop.parents,hot.parents
2019,1,WCR2019_0671,2,WCR2019_0585,WCR2019_0327,within-group subordinate,within-group subordinate,73,47,26,4,23,51,70,1,99999,860,829,829,0.37906976744186,0,0,NA,NA,none,hothiphop.parents,hot.parents
2019,1,WCR2019_0671,3,WCR2019_0585,WCR2019_0122,within-group subordinate,within-group subordinate,78,36,42,4,40,40,76,1,99999,860,848,848,0.37906976744186,0,0,NA,NA,none,hothiphop.parents,hot.parents
2019,1,WCR2019_0672,1,WCR2019_0440,WCR2019_0087,within-group subordinate,within-group subordinate,65,22,43,27,50,49,72,1,99999,566,625,412,0.382730455075846,0,0,NA,NA,none,hothiphop.parents,hot.parents
2019,1,WCR2019_0672,2,WCR2019_0223,WCR2019_0087,within-group subordinate,within-group subordinate,65,18,47,30,50,48,68,1,99999,488,625,355,0.382730455075846,0,0,NA,NA,none,hothiphop.parents,hot.parents
2019,1,WCR2019_0672,3,WCR2019_0223,WCR2019_0061,within-group subordinate,within-group subordinate,70,27,43,30,43,57,70,1,99999,488,759,425,0.382730455075846,0,0,NA,NA,none,hothiphop.parents,hot.parents
2019,1,WCR2019_0675,1,WCR2019_0223,WCR2019_0087,within-group subordinate,within-group subordinate,63,19,44,29,49,48,68,1,99999,456,595,338,0.400247831474597,0,0,NA,NA,none,hothiphop.parents,hot.parents
2019,1,WCR2019_0675,2,WCR2019_0440,WCR2019_0327,within-group subordinate,within-group subordinate,68,38,30,24,28,62,66,1,99999,535,778,517,0.400247831474597,0,0,NA,NA,none,hothiphop.parents,hot.parents
2019,1,WCR2019_0675,3,WCR2019_0223,WCR2019_0327,within-group subordinate,within-group subordinate,68,28,40,29,28,57,56,1,99999,456,778,442,0.400247831474597,0,0,NA,NA,none,hothiphop.parents,hot.parents
2019,1,WCR2019_0676,1,WCR2019_0223,WCR2019_0061,within-group subordinate,within-group subordinate,59,24,35,30,44,54,68,1,99999,489,762,426,0.331395348837209,0,0,NA,NA,none,hothiphop.parents,hot.parents
2019,1,WCR2019_0676,2,WCR2019_0223,WCR2019_0087,within-group subordinate,within-group subordinate,59,17,42,30,53,47,70,1,99999,489,627,356,0.331395348837209,0,0,NA,NA,none,hothiphop.parents,hot.parents
2019,1,WCR2019_0676,3,WCR2019_0223,WCR2019_0073,within-group subordinate,within-group subordinate,69,24,45,30,53,54,77,1,99999,489,788,438,0.331395348837209,0,0,NA,NA,none,hothiphop.parents,hot.parents
2019,1,WCR2019_0677,1,WCR2019_0223,WCR2019_0061,within-group subordinate,within-group subordinate,49,21,28,22,31,43,52,1,99999,461,715,400,0.419235511713933,0,0,NA,NA,none,hothiphop.parents,hot.parents
2019,1,WCR2019_0677,2,WCR2019_0223,WCR2019_0075,within-group subordinate,within-group subordinate,54,32,22,22,31,54,63,1,99999,461,708,394,0.419235511713933,0,0,NA,NA,none,hothiphop.parents,hot.parents
2019,1,WCR2019_0677,3,WCR2019_0223,WCR2019_0327,within-group subordinate,within-group subordinate,54,29,25,22,16,51,45,1,99999,461,784,448,0.419235511713933,0,0,NA,NA,none,hothiphop.parents,hot.parents
2019,1,WCR2019_0678,1,WCR2019_0223,WCR2019_0061,within-group subordinate,within-group subordinate,65,28,37,31,43,59,71,1,99999,489,762,426,0.36046511627907,0,0,NA,NA,none,hothiphop.parents,hot.parents
2019,1,WCR2019_0678,2,WCR2019_0223,WCR2019_0087,within-group subordinate,within-group subordinate,68,23,45,31,53,54,76,1,99999,489,627,356,0.36046511627907,0,0,NA,NA,none,hothiphop.parents,hot.parents
2019,1,WCR2019_0678,3,WCR2019_0223,WCR2019_0327,within-group subordinate,within-group subordinate,74,36,38,31,23,67,59,1,99999,489,829,474,0.36046511627907,0,0,NA,NA,none,hothiphop.parents,hot.parents
2019,1,WCR2019_0679,1,WCR2019_0223,WCR2019_0087,within-group subordinate,within-group subordinate,58,22,36,24,54,46,76,1,99999,474,615,346,0.361474435196195,0,0,NA,NA,none,hothiphop.parents,hot.parents
2019,1,WCR2019_0679,2,WCR2019_0223,WCR2019_0061,within-group subordinate,within-group subordinate,64,31,33,24,44,55,75,1,99999,474,749,416,0.361474435196195,0,0,NA,NA,none,hothiphop.parents,hot.parents
2019,1,WCR2019_0679,3,WCR2019_0223,WCR2019_0073,within-group subordinate,within-group subordinate,70,32,38,24,49,56,81,1,99999,474,772,425,0.361474435196195,0,0,NA,NA,none,hothiphop.parents,hot.parents
2019,1,WCR2019_0680,1,WCR2019_0223,WCR2019_0061,within-group subordinate,within-group subordinate,70,39,31,26,36,65,75,1,99999,489,762,426,0.380232558139535,0,0,NA,NA,none,hothiphop.parents,hot.parents
2019,1,WCR2019_0680,2,WCR2019_0223,WCR2019_0327,within-group subordinate,within-group subordinate,73,40,33,26,23,66,63,1,99999,489,829,474,0.380232558139535,0,0,NA,NA,none,hothiphop.parents,hot.parents
2019,1,WCR2019_0680,3,WCR2019_0440,WCR2019_0327,within-group subordinate,within-group subordinate,75,45,30,24,23,69,68,1,99999,569,829,549,0.380232558139535,0,0,NA,NA,none,hothiphop.parents,hot.parents
2019,1,WCR2019_0681,1,WCR2019_0223,WCR2019_0327,within-group subordinate,within-group subordinate,54,32,22,19,11,51,43,1,99999,488,828,473,0.385331781140861,0,0,NA,NA,none,hothiphop.parents,hot.parents
2019,1,WCR2019_0681,2,WCR2019_0223,WCR2019_0088,within-group subordinate,within-group subordinate,57,29,28,19,26,48,55,1,99999,488,645,380,0.385331781140861,0,0,NA,NA,none,hothiphop.parents,hot.parents
2019,1,WCR2019_0681,3,WCR2019_0440,WCR2019_0122,within-group subordinate,within-group subordinate,59,26,33,26,18,52,44,1,99999,568,847,562,0.385331781140861,0,0,NA,NA,none,hothiphop.parents,hot.parents
2019,1,WCR2019_0682,1,WCR2019_0440,WCR2019_0313,within-group subordinate,within-group subordinate,45,22,23,17,24,39,46,1,99999,555,825,547,0.391148325358852,0,0,NA,NA,none,hothiphop.parents,hot.parents
2019,1,WCR2019_0682,2,WCR2019_0440,WCR2019_0122,within-group subordinate,within-group subordinate,46,23,23,17,17,40,40,1,99999,555,824,549,0.391148325358852,0,0,NA,NA,none,hothiphop.parents,hot.parents
2019,1,WCR2019_0682,3,WCR2019_0440,WCR2019_0161,within-group subordinate,within-group subordinate,48,24,24,17,16,41,40,1,99999,555,787,532,0.391148325358852,0,0,NA,NA,none,hothiphop.parents,hot.parents
2019,1,WCR2019_0683,1,WCR2019_0223,WCR2019_0087,within-group subordinate,within-group subordinate,61,26,35,25,39,51,65,1,99999,489,627,356,0.415116279069767,0,0,NA,NA,none,hothiphop.parents,hot.parents
2019,1,WCR2019_0683,2,WCR2019_0440,WCR2019_0327,within-group subordinate,within-group subordinate,71,39,32,25,27,64,66,1,99999,569,829,549,0.415116279069767,0,0,NA,NA,none,hothiphop.parents,hot.parents
2019,1,WCR2019_0683,3,WCR2019_0440,WCR2019_0122,within-group subordinate,within-group subordinate,73,32,41,25,36,57,68,1,99999,569,848,563,0.415116279069767,0,0,NA,NA,none,hothiphop.parents,hot.parents
2019,1,WCR2019_0686,1,WCR2019_0223,WCR2019_0088,within-group subordinate,within-group subordinate,38,25,13,16,13,41,38,1,99999,487,644,379,0.462703962703963,0,0,NA,NA,none,hothiphop.parents,hot.parents
2019,1,WCR2019_0686,2,WCR2019_0223,WCR2019_0327,within-group subordinate,within-group subordinate,44,25,19,16,9,41,34,1,99999,487,827,472,0.462703962703963,0,0,NA,NA,none,hothiphop.parents,hot.parents
2019,1,WCR2019_0686,3,WCR2019_0223,WCR2019_0161,within-group subordinate,within-group subordinate,47,29,18,16,14,45,43,1,99999,487,808,468,0.462703962703963,0,0,NA,NA,none,hothiphop.parents,hot.parents
2019,1,WCR2019_0688,1,WCR2019_0223,WCR2019_0327,within-group subordinate,within-group subordinate,62,31,31,28,23,59,54,1,99999,484,821,469,0.36192714453584,0,0,NA,NA,none,hothiphop.parents,hot.parents
2019,1,WCR2019_0688,2,WCR2019_0223,WCR2019_0087,within-group subordinate,within-group subordinate,63,28,35,28,38,56,66,1,99999,484,621,352,0.36192714453584,0,0,NA,NA,none,hothiphop.parents,hot.parents
2019,1,WCR2019_0688,3,WCR2019_0440,WCR2019_0087,within-group subordinate,within-group subordinate,68,27,41,23,38,50,65,1,99999,561,621,408,0.36192714453584,0,0,NA,NA,none,hothiphop.parents,hot.parents
2019,1,WCR2019_0690,1,WCR2019_0223,WCR2019_0061,within-group subordinate,within-group subordinate,66,26,40,30,37,56,63,1,99999,480,750,420,0.355029585798817,0,0,NA,NA,none,hothiphop.parents,hot.parents
2019,1,WCR2019_0690,2,WCR2019_0223,WCR2019_0087,within-group subordinate,within-group subordinate,70,24,46,30,50,54,74,1,99999,480,619,351,0.355029585798817,0,0,NA,NA,none,hothiphop.parents,hot.parents
2019,1,WCR2019_0690,3,WCR2019_0440,WCR2019_0061,within-group subordinate,within-group subordinate,75,39,36,27,37,66,76,1,99999,558,750,494,0.355029585798817,0,0,NA,NA,none,hothiphop.parents,hot.parents
2019,1,WCR2019_0693,1,WCR2019_0440,WCR2019_0122,within-group subordinate,within-group subordinate,46,28,18,17,2,45,30,1,99999,538,799,533,0.425216316440049,0,0,NA,NA,none,hothiphop.parents,hot.parents
2019,1,WCR2019_0693,2,WCR2019_0440,WCR2019_0161,within-group subordinate,within-group subordinate,51,29,22,17,13,46,42,1,99999,538,760,516,0.425216316440049,0,0,NA,NA,none,hothiphop.parents,hot.parents
2019,1,WCR2019_0693,3,WCR2019_0223,WCR2019_0327,within-group subordinate,within-group subordinate,55,28,27,27,4,55,32,1,99999,463,779,449,0.425216316440049,0,0,NA,NA,none,hothiphop.parents,hot.parents
2019,1,WCR2019_0695,1,WCR2019_0223,WCR2019_0087,within-group subordinate,within-group subordinate,54,28,26,23,36,51,64,1,99999,435,554,314,0.413071895424837,0,0,NA,NA,none,hothiphop.parents,hot.parents
2019,1,WCR2019_0695,2,WCR2019_0191,WCR2019_0087,within-group subordinate,within-group subordinate,60,27,33,22,36,49,63,1,99999,588,554,414,0.413071895424837,0,0,NA,NA,none,hothiphop.parents,hot.parents
2019,1,WCR2019_0695,3,WCR2019_0223,WCR2019_0061,within-group subordinate,within-group subordinate,63,33,30,23,36,56,69,1,99999,435,673,377,0.413071895424837,0,0,NA,NA,none,hothiphop.parents,hot.parents
2019,1,WCR2019_0698,1,WCR2019_0337,WCR2019_0405,within-group subordinate,within-group subordinate,4,0,4,1,3,1,3,1,99999,851,804,801,0.463700234192037,0,0,NA,NA,none,hothiphop.parents,hot.parents
2019,1,WCR2019_0698,2,WCR2019_0337,WCR2019_0265,within-group subordinate,within-group subordinate,8,7,1,1,0,8,7,1,99999,851,846,843,0.463700234192037,0,0,NA,NA,none,hothiphop.parents,hot.parents
2019,1,WCR2019_0698,3,WCR2019_0337,WCR2019_0518,within-group subordinate,within-group subordinate,9,6,3,1,2,7,8,1,99999,851,843,840,0.463700234192037,0,0,NA,NA,none,hothiphop.parents,hot.parents
2019,1,WCR2019_0699,1,WCR2019_0223,WCR2019_0087,within-group subordinate,within-group subordinate,65,25,40,28,38,53,63,1,99999,489,627,356,0.367441860465116,0,0,NA,NA,none,hothiphop.parents,hot.parents
2019,1,WCR2019_0699,2,WCR2019_0585,WCR2019_0327,within-group subordinate,within-group subordinate,71,42,29,3,27,45,69,1,99999,860,829,829,0.367441860465116,0,0,NA,NA,none,hothiphop.parents,hot.parents
2019,1,WCR2019_0699,3,WCR2019_0585,WCR2019_0087,within-group subordinate,within-group subordinate,74,34,40,3,38,37,72,1,99999,860,627,627,0.367441860465116,0,0,NA,NA,none,hothiphop.parents,hot.parents
2019,1,WCR2019_0700,1,WCR2019_0223,WCR2019_0087,within-group subordinate,within-group subordinate,61,22,39,37,40,59,62,1,99999,478,619,352,0.385798816568047,0,0,NA,NA,none,hothiphop.parents,hot.parents
2019,1,WCR2019_0700,2,WCR2019_0223,WCR2019_0061,within-group subordinate,within-group subordinate,71,27,44,37,37,64,64,1,99999,478,750,418,0.385798816568047,0,0,NA,NA,none,hothiphop.parents,hot.parents
2019,1,WCR2019_0700,3,WCR2019_0440,WCR2019_0327,within-group subordinate,within-group subordinate,74,33,41,34,31,67,64,1,99999,555,814,535,0.385798816568047,0,0,NA,NA,none,hothiphop.parents,hot.parents
2019,1,WCR2019_0701,1,WCR2019_0223,WCR2019_0061,within-group subordinate,within-group subordinate,61,26,35,27,39,53,65,1,99999,489,762,426,0.367869615832363,0,0,NA,NA,none,hothiphop.parents,hot.parents
2019,1,WCR2019_0701,2,WCR2019_0223,WCR2019_0087,within-group subordinate,within-group subordinate,64,22,42,27,56,49,78,1,99999,489,627,356,0.367869615832363,0,0,NA,NA,none,hothiphop.parents,hot.parents
2019,1,WCR2019_0701,3,WCR2019_0223,WCR2019_0327,within-group subordinate,within-group subordinate,67,31,36,27,29,58,60,1,99999,489,828,474,0.367869615832363,0,0,NA,NA,none,hothiphop.parents,hot.parents
2019,1,WCR2019_0702,1,WCR2019_0318,WCR2019_0088,within-group subordinate,within-group subordinate,17,16,1,1,1,17,17,1,99999,855,644,642,0.247374562427071,0,0,NA,NA,none,hothiphop.parents,hot.parents
2019,1,WCR2019_0702,2,WCR2019_0318,WCR2019_0075,within-group subordinate,within-group subordinate,21,14,7,1,7,15,21,1,99999,855,748,746,0.247374562427071,0,0,NA,NA,none,hothiphop.parents,hot.parents
2019,1,WCR2019_0702,3,WCR2019_0318,WCR2019_0327,within-group subordinate,within-group subordinate,21,13,8,1,7,14,20,1,99999,855,826,824,0.247374562427071,0,0,NA,NA,none,hothiphop.parents,hot.parents
2019,1,WCR2019_0703,1,WCR2019_0223,WCR2019_0161,within-group subordinate,within-group subordinate,54,26,28,24,17,50,43,1,99999,487,805,468,0.398830409356725,0,0,NA,NA,none,hothiphop.parents,hot.parents
2019,1,WCR2019_0703,2,WCR2019_0223,WCR2019_0327,within-group subordinate,within-group subordinate,54,24,30,24,14,48,38,1,99999,487,824,472,0.398830409356725,0,0,NA,NA,none,hothiphop.parents,hot.parents
2019,1,WCR2019_0703,3,WCR2019_0440,WCR2019_0122,within-group subordinate,within-group subordinate,59,24,35,29,24,53,48,1,99999,565,843,559,0.398830409356725,0,0,NA,NA,none,hothiphop.parents,hot.parents
2019,1,WCR2019_0704,1,WCR2019_0223,WCR2019_0061,within-group subordinate,within-group subordinate,59,25,34,23,38,48,63,1,99999,488,761,426,0.365967365967366,0,0,NA,NA,none,hothiphop.parents,hot.parents
2019,1,WCR2019_0704,2,WCR2019_0223,WCR2019_0087,within-group subordinate,within-group subordinate,62,22,40,23,50,45,72,1,99999,488,626,355,0.365967365967366,0,0,NA,NA,none,hothiphop.parents,hot.parents
2019,1,WCR2019_0704,3,WCR2019_0223,WCR2019_0073,within-group subordinate,within-group subordinate,65,31,34,23,41,54,72,1,99999,488,787,438,0.365967365967366,0,0,NA,NA,none,hothiphop.parents,hot.parents
2019,1,WCR2019_0705,1,WCR2019_0223,WCR2019_0087,within-group subordinate,within-group subordinate,65,29,36,20,45,49,74,1,99999,489,627,356,0.378346915017462,0,0,NA,NA,none,hothiphop.parents,hot.parents
2019,1,WCR2019_0705,2,WCR2019_0223,WCR2019_0327,within-group subordinate,within-group subordinate,66,35,31,20,28,55,63,1,99999,489,828,474,0.378346915017462,0,0,NA,NA,none,hothiphop.parents,hot.parents
2019,1,WCR2019_0705,3,WCR2019_0223,WCR2019_0061,within-group subordinate,within-group subordinate,66,34,32,20,40,54,74,1,99999,489,761,426,0.378346915017462,0,0,NA,NA,none,hothiphop.parents,hot.parents
2019,1,WCR2019_0706,1,WCR2019_0223,WCR2019_0327,within-group subordinate,within-group subordinate,52,26,26,24,19,50,45,1,99999,486,824,471,0.404678362573099,0,0,NA,NA,none,hothiphop.parents,hot.parents
2019,1,WCR2019_0706,2,WCR2019_0223,WCR2019_0087,within-group subordinate,within-group subordinate,56,18,38,24,46,42,64,1,99999,486,623,353,0.404678362573099,0,0,NA,NA,none,hothiphop.parents,hot.parents
2019,1,WCR2019_0706,3,WCR2019_0223,WCR2019_0061,within-group subordinate,within-group subordinate,59,25,34,24,37,49,62,1,99999,486,757,423,0.404678362573099,0,0,NA,NA,none,hothiphop.parents,hot.parents
2019,1,WCR2019_0707,1,WCR2019_0223,WCR2019_0087,within-group subordinate,within-group subordinate,64,21,43,30,52,51,73,1,99999,488,627,356,0.34965034965035,0,0,NA,NA,none,hothiphop.parents,hot.parents
2019,1,WCR2019_0707,2,WCR2019_0223,WCR2019_0061,within-group subordinate,within-group subordinate,69,28,41,30,46,58,74,1,99999,488,762,426,0.34965034965035,0,0,NA,NA,none,hothiphop.parents,hot.parents
2019,1,WCR2019_0707,3,WCR2019_0223,WCR2019_0073,within-group subordinate,within-group subordinate,72,27,45,30,52,57,79,1,99999,488,787,438,0.34965034965035,0,0,NA,NA,none,hothiphop.parents,hot.parents
2019,1,WCR2019_0708,1,WCR2019_0223,WCR2019_0087,within-group subordinate,within-group subordinate,66,24,42,29,46,53,70,1,99999,489,626,356,0.379511059371362,0,0,NA,NA,none,hothiphop.parents,hot.parents
2019,1,WCR2019_0708,2,WCR2019_0223,WCR2019_0061,within-group subordinate,within-group subordinate,69,31,38,29,43,60,74,1,99999,489,761,426,0.379511059371362,0,0,NA,NA,none,hothiphop.parents,hot.parents
2019,1,WCR2019_0708,3,WCR2019_0585,WCR2019_0327,within-group subordinate,within-group subordinate,70,45,25,3,24,48,69,1,99999,859,828,828,0.379511059371362,0,0,NA,NA,none,hothiphop.parents,hot.parents
2019,1,WCR2019_0709,1,WCR2019_0223,WCR2019_0087,within-group subordinate,within-group subordinate,49,18,31,19,44,37,62,1,99999,476,614,346,0.381235154394299,0,0,NA,NA,none,hothiphop.parents,hot.parents
2019,1,WCR2019_0709,2,WCR2019_0223,WCR2019_0061,within-group subordinate,within-group subordinate,54,25,29,19,36,44,61,1,99999,476,746,414,0.381235154394299,0,0,NA,NA,none,hothiphop.parents,hot.parents
2019,1,WCR2019_0709,3,WCR2019_0223,WCR2019_0161,within-group subordinate,within-group subordinate,61,34,27,19,26,53,60,1,99999,476,793,458,0.381235154394299,0,0,NA,NA,none,hothiphop.parents,hot.parents
2019,1,WCR2019_0710,1,WCR2019_0223,WCR2019_0087,within-group subordinate,within-group subordinate,60,20,40,25,48,45,68,1,99999,486,624,353,0.361726954492415,0,0,NA,NA,none,hothiphop.parents,hot.parents
2019,1,WCR2019_0710,2,WCR2019_0223,WCR2019_0061,within-group subordinate,within-group subordinate,63,30,33,25,38,55,68,1,99999,486,759,423,0.361726954492415,0,0,NA,NA,none,hothiphop.parents,hot.parents
2019,1,WCR2019_0710,3,WCR2019_0223,WCR2019_0073,within-group subordinate,within-group subordinate,68,29,39,25,46,54,75,1,99999,486,785,435,0.361726954492415,0,0,NA,NA,none,hothiphop.parents,hot.parents
2019,1,WCR2019_0711,1,WCR2019_0223,WCR2019_0087,within-group subordinate,within-group subordinate,70,31,39,28,39,59,70,1,99999,488,625,355,0.408878504672897,0,0,NA,NA,none,hothiphop.parents,hot.parents
2019,1,WCR2019_0711,2,WCR2019_0223,WCR2019_0161,within-group subordinate,within-group subordinate,74,38,36,28,40,66,78,1,99999,488,806,469,0.408878504672897,0,0,NA,NA,none,hothiphop.parents,hot.parents
2019,1,WCR2019_0711,3,WCR2019_0440,WCR2019_0122,within-group subordinate,within-group subordinate,76,35,41,21,36,56,71,1,99999,567,844,561,0.408878504672897,0,0,NA,NA,none,hothiphop.parents,hot.parents
2019,1,WCR2019_0712,1,WCR2019_0223,WCR2019_0087,within-group subordinate,within-group subordinate,66,21,45,33,48,54,69,1,99999,488,626,355,0.330616996507567,0,0,NA,NA,none,hothiphop.parents,hot.parents
2019,1,WCR2019_0712,2,WCR2019_0223,WCR2019_0061,within-group subordinate,within-group subordinate,70,29,41,33,46,62,75,1,99999,488,762,426,0.330616996507567,0,0,NA,NA,none,hothiphop.parents,hot.parents
2019,1,WCR2019_0712,3,WCR2019_0223,WCR2019_0073,within-group subordinate,within-group subordinate,71,31,40,33,49,64,80,1,99999,488,787,437,0.330616996507567,0,0,NA,NA,none,hothiphop.parents,hot.parents
2019,1,WCR2019_0714,1,WCR2019_0223,WCR2019_0087,within-group subordinate,within-group subordinate,58,18,40,33,39,51,57,1,99999,463,588,335,0.359605911330049,0,0,NA,NA,none,hothiphop.parents,hot.parents
2019,1,WCR2019_0714,2,WCR2019_0440,WCR2019_0087,within-group subordinate,within-group subordinate,62,21,41,29,39,50,60,1,99999,542,588,392,0.359605911330049,0,0,NA,NA,none,hothiphop.parents,hot.parents
2019,1,WCR2019_0714,3,WCR2019_0585,WCR2019_0327,within-group subordinate,within-group subordinate,70,37,33,2,32,39,69,1,99999,812,783,783,0.359605911330049,0,0,NA,NA,none,hothiphop.parents,hot.parents
2019,1,WCR2019_0716,1,WCR2019_0223,WCR2019_0088,within-group subordinate,within-group subordinate,59,31,28,26,28,57,59,1,99999,487,645,380,0.428904428904429,0,0,NA,NA,none,hothiphop.parents,hot.parents
2019,1,WCR2019_0716,2,WCR2019_0223,WCR2019_0087,within-group subordinate,within-group subordinate,60,29,31,26,38,55,67,1,99999,487,626,355,0.428904428904429,0,0,NA,NA,none,hothiphop.parents,hot.parents
2019,1,WCR2019_0716,3,WCR2019_0223,WCR2019_0061,within-group subordinate,within-group subordinate,61,32,29,26,30,58,62,1,99999,487,761,425,0.428904428904429,0,0,NA,NA,none,hothiphop.parents,hot.parents
2019,1,WCR2019_0717,1,WCR2019_0223,WCR2019_0327,within-group subordinate,within-group subordinate,43,22,21,17,12,39,34,1,99999,487,827,472,0.451048951048951,0,0,NA,NA,none,hothiphop.parents,hot.parents
2019,1,WCR2019_0717,2,WCR2019_0223,WCR2019_0088,within-group subordinate,within-group subordinate,44,25,19,17,16,42,41,1,99999,487,645,380,0.451048951048951,0,0,NA,NA,none,hothiphop.parents,hot.parents
2019,1,WCR2019_0717,3,WCR2019_0223,WCR2019_0161,within-group subordinate,within-group subordinate,46,27,19,17,15,44,42,1,99999,487,808,468,0.451048951048951,0,0,NA,NA,none,hothiphop.parents,hot.parents
2019,1,WCR2019_0718,1,WCR2019_0223,WCR2019_0087,within-group subordinate,within-group subordinate,57,23,34,29,34,52,57,1,99999,488,626,355,0.40162980209546,0,0,NA,NA,none,hothiphop.parents,hot.parents
2019,1,WCR2019_0718,2,WCR2019_0440,WCR2019_0087,within-group subordinate,within-group subordinate,62,31,31,24,34,55,65,1,99999,568,626,413,0.40162980209546,0,0,NA,NA,none,hothiphop.parents,hot.parents
2019,1,WCR2019_0718,3,WCR2019_0223,WCR2019_0061,within-group subordinate,within-group subordinate,67,32,35,29,35,61,67,1,99999,488,761,425,0.40162980209546,0,0,NA,NA,none,hothiphop.parents,hot.parents
2019,1,WCR2019_0719,1,WCR2019_0194,WCR2019_0122,within-group subordinate,within-group subordinate,46,22,24,2,22,24,44,1,99999,714,710,706,0.427576601671309,0,0,NA,NA,none,hothiphop.parents,hot.parents
2019,1,WCR2019_0719,2,WCR2019_0223,WCR2019_0088,within-group subordinate,within-group subordinate,50,21,29,20,31,41,52,1,99999,421,533,326,0.427576601671309,0,0,NA,NA,none,hothiphop.parents,hot.parents
2019,1,WCR2019_0719,3,WCR2019_0194,WCR2019_0327,within-group subordinate,within-group subordinate,51,36,15,2,14,38,50,1,99999,714,691,688,0.427576601671309,0,0,NA,NA,none,hothiphop.parents,hot.parents
2019,1,WCR2019_0720,1,WCR2019_0440,WCR2019_0122,within-group subordinate,within-group subordinate,67,32,35,21,29,53,61,1,99999,562,840,556,0.376760563380282,0,0,NA,NA,none,hothiphop.parents,hot.parents
2019,1,WCR2019_0720,2,WCR2019_0223,WCR2019_0327,within-group subordinate,within-group subordinate,70,32,38,31,31,63,63,1,99999,486,821,471,0.376760563380282,0,0,NA,NA,none,hothiphop.parents,hot.parents
2019,1,WCR2019_0720,3,WCR2019_0440,WCR2019_0087,within-group subordinate,within-group subordinate,70,31,39,21,46,52,77,1,99999,562,622,409,0.376760563380282,0,0,NA,NA,none,hothiphop.parents,hot.parents
2019,1,WCR2019_0721,1,WCR2019_0440,WCR2019_0327,within-group subordinate,within-group subordinate,59,33,26,24,15,57,48,1,99999,565,825,545,0.398364485981308,0,0,NA,NA,none,hothiphop.parents,hot.parents
2019,1,WCR2019_0721,2,WCR2019_0223,WCR2019_0061,within-group subordinate,within-group subordinate,66,36,30,27,32,63,68,1,99999,485,758,422,0.398364485981308,0,0,NA,NA,none,hothiphop.parents,hot.parents
2019,1,WCR2019_0721,3,WCR2019_0223,WCR2019_0327,within-group subordinate,within-group subordinate,67,40,27,27,15,67,55,1,99999,485,825,470,0.398364485981308,0,0,NA,NA,none,hothiphop.parents,hot.parents
2019,1,WCR2019_0722,1,WCR2019_0361,WCR2019_0047,within-group subordinate,within-group subordinate,37,30,7,5,3,35,33,1,99999,791,850,790,0.266745005875441,0,0,NA,NA,none,hothiphop.parents,hot.parents
2019,1,WCR2019_0722,2,WCR2019_0474,WCR2019_0327,within-group subordinate,within-group subordinate,37,30,7,3,5,33,35,1,99999,730,820,705,0.266745005875441,0,0,NA,NA,none,hothiphop.parents,hot.parents
2019,1,WCR2019_0722,3,WCR2019_0263,WCR2019_0327,within-group subordinate,within-group subordinate,37,28,9,5,5,33,33,1,99999,843,820,814,0.266745005875441,0,0,NA,NA,none,hothiphop.parents,hot.parents
2019,1,WCR2019_0723,1,WCR2019_0223,WCR2019_0087,within-group subordinate,within-group subordinate,64,27,37,29,38,56,65,1,99999,488,625,355,0.409568261376896,0,0,NA,NA,none,hothiphop.parents,hot.parents
2019,1,WCR2019_0723,2,WCR2019_0223,WCR2019_0075,within-group subordinate,within-group subordinate,65,29,36,29,49,58,78,1,99999,488,747,418,0.409568261376896,0,0,NA,NA,none,hothiphop.parents,hot.parents
2019,1,WCR2019_0723,3,WCR2019_0223,WCR2019_0088,within-group subordinate,within-group subordinate,69,31,38,29,40,60,71,1,99999,488,645,381,0.409568261376896,0,0,NA,NA,none,hothiphop.parents,hot.parents
2019,1,WCR2019_0724,1,WCR2019_0223,WCR2019_0087,within-group subordinate,within-group subordinate,56,23,33,26,38,49,61,1,99999,489,627,356,0.372093023255814,0,0,NA,NA,none,hothiphop.parents,hot.parents
2019,1,WCR2019_0724,2,WCR2019_0440,WCR2019_0087,within-group subordinate,within-group subordinate,65,25,40,22,38,47,63,1,99999,569,627,414,0.372093023255814,0,0,NA,NA,none,hothiphop.parents,hot.parents
2019,1,WCR2019_0724,3,WCR2019_0223,WCR2019_0327,within-group subordinate,within-group subordinate,66,34,32,26,24,60,58,1,99999,489,829,474,0.372093023255814,0,0,NA,NA,none,hothiphop.parents,hot.parents
2019,1,WCR2019_0725,1,WCR2019_0223,WCR2019_0461,within-group subordinate,within-group subordinate,44,24,20,20,2,44,26,1,99999,488,855,487,0.379511059371362,0,0,NA,NA,none,hothiphop.parents,hot.parents
2019,1,WCR2019_0725,2,WCR2019_0223,WCR2019_0087,within-group subordinate,within-group subordinate,54,21,33,20,36,41,57,1,99999,488,627,356,0.379511059371362,0,0,NA,NA,none,hothiphop.parents,hot.parents
2019,1,WCR2019_0725,3,WCR2019_0223,WCR2019_0327,within-group subordinate,within-group subordinate,55,26,29,20,26,46,52,1,99999,488,828,473,0.379511059371362,0,0,NA,NA,none,hothiphop.parents,hot.parents
2019,1,WCR2019_0726,1,WCR2019_0223,WCR2019_0087,within-group subordinate,within-group subordinate,59,16,43,33,45,49,61,1,99999,480,612,351,0.353643966547192,0,0,NA,NA,none,hothiphop.parents,hot.parents
2019,1,WCR2019_0726,2,WCR2019_0223,WCR2019_0327,within-group subordinate,within-group subordinate,72,32,40,33,29,65,61,1,99999,480,806,465,0.353643966547192,0,0,NA,NA,none,hothiphop.parents,hot.parents
2019,1,WCR2019_0726,3,WCR2019_0440,WCR2019_0087,within-group subordinate,within-group subordinate,73,27,46,24,45,51,72,1,99999,552,612,403,0.353643966547192,0,0,NA,NA,none,hothiphop.parents,hot.parents
2019,1,WCR2019_0727,1,WCR2019_0223,WCR2019_0327,within-group subordinate,within-group subordinate,51,28,23,20,21,48,49,1,99999,485,823,470,0.336065573770492,0,0,NA,NA,none,hothiphop.parents,hot.parents
2019,1,WCR2019_0727,2,WCR2019_0223,WCR2019_0087,within-group subordinate,within-group subordinate,52,24,28,20,32,44,56,1,99999,485,624,354,0.336065573770492,0,0,NA,NA,none,hothiphop.parents,hot.parents
2019,1,WCR2019_0727,3,WCR2019_0532,WCR2019_0327,within-group subordinate,within-group subordinate,58,36,22,2,21,38,57,1,99999,843,823,812,0.336065573770492,0,0,NA,NA,none,hothiphop.parents,hot.parents
2019,1,WCR2019_0728,1,WCR2019_0223,WCR2019_0516,within-group subordinate,within-group subordinate,58,31,27,27,2,58,33,1,99999,488,849,486,0.376896149358226,0,0,NA,NA,none,hothiphop.parents,hot.parents
2019,1,WCR2019_0728,2,WCR2019_0440,WCR2019_0516,within-group subordinate,within-group subordinate,63,35,28,28,2,63,37,1,99999,568,849,564,0.376896149358226,0,0,NA,NA,none,hothiphop.parents,hot.parents
2019,1,WCR2019_0728,3,WCR2019_0440,WCR2019_0087,within-group subordinate,within-group subordinate,67,29,38,28,38,57,67,1,99999,568,625,414,0.376896149358226,0,0,NA,NA,none,hothiphop.parents,hot.parents
2019,1,WCR2019_0729,1,WCR2019_0223,WCR2019_0087,within-group subordinate,within-group subordinate,54,12,42,29,42,41,54,1,99999,471,605,343,0.340168878166466,0,0,NA,NA,none,hothiphop.parents,hot.parents
2019,1,WCR2019_0729,2,WCR2019_0223,WCR2019_0327,within-group subordinate,within-group subordinate,55,18,37,29,25,47,43,1,99999,471,801,459,0.340168878166466,0,0,NA,NA,none,hothiphop.parents,hot.parents
2019,1,WCR2019_0729,3,WCR2019_0223,WCR2019_0088,within-group subordinate,within-group subordinate,57,18,39,29,40,47,58,1,99999,471,625,368,0.340168878166466,0,0,NA,NA,none,hothiphop.parents,hot.parents
2019,1,WCR2019_0730,1,WCR2019_0223,WCR2019_0327,within-group subordinate,within-group subordinate,55,32,23,17,23,49,55,1,99999,471,794,457,0.43134872417983,0,0,NA,NA,none,hothiphop.parents,hot.parents
2019,1,WCR2019_0730,2,WCR2019_0223,WCR2019_0088,within-group subordinate,within-group subordinate,57,32,25,17,25,49,57,1,99999,471,616,368,0.43134872417983,0,0,NA,NA,none,hothiphop.parents,hot.parents
2019,1,WCR2019_0730,3,WCR2019_0440,WCR2019_0109,within-group subordinate,within-group subordinate,57,24,33,29,31,53,55,1,99999,541,791,522,0.43134872417983,0,0,NA,NA,none,hothiphop.parents,hot.parents
2019,1,WCR2019_0731,1,WCR2019_0223,WCR2019_0327,within-group subordinate,within-group subordinate,44,21,23,20,12,41,33,1,99999,483,823,468,0.365339578454333,0,0,NA,NA,none,hothiphop.parents,hot.parents
2019,1,WCR2019_0731,2,WCR2019_0223,WCR2019_0088,within-group subordinate,within-group subordinate,46,20,26,20,29,40,49,1,99999,483,641,376,0.365339578454333,0,0,NA,NA,none,hothiphop.parents,hot.parents
2019,1,WCR2019_0731,3,WCR2019_0223,WCR2019_0161,within-group subordinate,within-group subordinate,49,26,23,20,20,46,46,1,99999,483,805,465,0.365339578454333,0,0,NA,NA,none,hothiphop.parents,hot.parents
2019,1,WCR2019_0733,1,WCR2019_0223,WCR2019_0087,within-group subordinate,within-group subordinate,59,29,30,24,34,53,63,1,99999,489,627,356,0.416279069767442,0,0,NA,NA,none,hothiphop.parents,hot.parents
2019,1,WCR2019_0733,2,WCR2019_0223,WCR2019_0516,within-group subordinate,within-group subordinate,63,39,24,24,2,63,41,1,99999,489,852,487,0.416279069767442,0,0,NA,NA,none,hothiphop.parents,hot.parents
2019,1,WCR2019_0733,3,WCR2019_0440,WCR2019_0516,within-group subordinate,within-group subordinate,65,39,26,25,2,64,41,1,99999,569,852,565,0.416279069767442,0,0,NA,NA,none,hothiphop.parents,hot.parents
2019,1,WCR2019_0734,1,WCR2019_0223,WCR2019_0087,within-group subordinate,within-group subordinate,57,21,36,26,34,47,55,1,99999,486,624,354,0.384345794392523,0,0,NA,NA,none,hothiphop.parents,hot.parents
2019,1,WCR2019_0734,2,WCR2019_0223,WCR2019_0461,within-group subordinate,within-group subordinate,58,32,26,26,2,58,34,1,99999,486,852,485,0.384345794392523,0,0,NA,NA,none,hothiphop.parents,hot.parents
2019,1,WCR2019_0734,3,WCR2019_0223,WCR2019_0327,within-group subordinate,within-group subordinate,63,26,37,26,30,52,56,1,99999,486,825,471,0.384345794392523,0,0,NA,NA,none,hothiphop.parents,hot.parents
2019,1,WCR2019_0735,1,WCR2019_0337,WCR2019_0405,within-group subordinate,within-group subordinate,6,0,6,2,4,2,4,1,99999,849,802,799,0.449530516431925,0,0,NA,NA,none,hothiphop.parents,hot.parents
2019,1,WCR2019_0735,2,WCR2019_0337,WCR2019_0088,within-group subordinate,within-group subordinate,11,7,4,2,3,9,10,1,99999,849,638,635,0.449530516431925,0,0,NA,NA,none,hothiphop.parents,hot.parents
2019,1,WCR2019_0735,3,WCR2019_0337,WCR2019_0047,within-group subordinate,within-group subordinate,12,9,3,2,1,11,10,1,99999,849,851,848,0.449530516431925,0,0,NA,NA,none,hothiphop.parents,hot.parents
2019,1,WCR2019_0736,1,WCR2019_0223,WCR2019_0088,within-group subordinate,within-group subordinate,46,21,25,25,25,46,46,1,99999,488,645,380,0.461001164144354,0,0,NA,NA,none,hothiphop.parents,hot.parents
2019,1,WCR2019_0736,2,WCR2019_0223,WCR2019_0122,within-group subordinate,within-group subordinate,55,27,28,25,15,52,42,1,99999,488,847,481,0.461001164144354,0,0,NA,NA,none,hothiphop.parents,hot.parents
2019,1,WCR2019_0736,3,WCR2019_0223,WCR2019_0061,within-group subordinate,within-group subordinate,57,30,27,25,21,55,51,1,99999,488,761,425,0.461001164144354,0,0,NA,NA,none,hothiphop.parents,hot.parents
2019,1,WCR2019_0737,1,WCR2019_0223,WCR2019_0061,within-group subordinate,within-group subordinate,52,29,23,22,27,51,56,1,99999,475,739,414,0.382035928143713,0,0,NA,NA,none,hothiphop.parents,hot.parents
2019,1,WCR2019_0737,2,WCR2019_0223,WCR2019_0461,within-group subordinate,within-group subordinate,54,29,25,22,6,51,35,1,99999,475,832,474,0.382035928143713,0,0,NA,NA,none,hothiphop.parents,hot.parents
2019,1,WCR2019_0737,3,WCR2019_0223,WCR2019_0087,within-group subordinate,within-group subordinate,57,26,31,22,35,48,61,1,99999,475,613,348,0.382035928143713,0,0,NA,NA,none,hothiphop.parents,hot.parents
2019,1,WCR2019_0738,1,WCR2019_0223,WCR2019_0088,within-group subordinate,within-group subordinate,27,20,7,11,2,31,22,1,99999,488,644,380,0.467365967365967,0,0,NA,NA,none,hothiphop.parents,hot.parents
2019,1,WCR2019_0738,2,WCR2019_0223,WCR2019_0327,within-group subordinate,within-group subordinate,35,24,11,11,2,35,26,1,99999,488,827,473,0.467365967365967,0,0,NA,NA,none,hothiphop.parents,hot.parents
2019,1,WCR2019_0738,3,WCR2019_0223,WCR2019_0206,within-group subordinate,within-group subordinate,36,25,11,11,4,36,29,1,99999,488,846,485,0.467365967365967,0,0,NA,NA,none,hothiphop.parents,hot.parents
2019,1,WCR2019_0739,1,WCR2019_0440,WCR2019_0327,within-group subordinate,within-group subordinate,66,39,27,18,20,57,59,1,99999,567,827,547,0.402097902097902,0,0,NA,NA,none,hothiphop.parents,hot.parents
2019,1,WCR2019_0739,2,WCR2019_0440,WCR2019_0122,within-group subordinate,within-group subordinate,66,28,38,18,36,46,64,1,99999,567,846,561,0.402097902097902,0,0,NA,NA,none,hothiphop.parents,hot.parents
2019,1,WCR2019_0739,3,WCR2019_0223,WCR2019_0279,within-group subordinate,within-group subordinate,67,28,39,32,38,60,66,1,99999,488,853,487,0.402097902097902,0,0,NA,NA,none,hothiphop.parents,hot.parents
2019,1,WCR2019_0740,1,WCR2019_0223,WCR2019_0327,within-group subordinate,within-group subordinate,64,21,43,33,35,54,56,1,99999,486,825,472,0.335672514619883,0,0,NA,NA,none,hothiphop.parents,hot.parents
2019,1,WCR2019_0740,2,WCR2019_0223,WCR2019_0087,within-group subordinate,within-group subordinate,73,21,52,33,53,54,74,1,99999,486,624,355,0.335672514619883,0,0,NA,NA,none,hothiphop.parents,hot.parents
2019,1,WCR2019_0740,3,WCR2019_0223,WCR2019_0061,within-group subordinate,within-group subordinate,74,30,44,33,41,63,71,1,99999,486,757,423,0.335672514619883,0,0,NA,NA,none,hothiphop.parents,hot.parents
2019,1,WCR2019_0741,1,WCR2019_0223,WCR2019_0327,within-group subordinate,within-group subordinate,54,29,25,23,18,52,47,1,99999,487,826,472,0.425904317386231,0,0,NA,NA,none,hothiphop.parents,hot.parents
2019,1,WCR2019_0741,2,WCR2019_0223,WCR2019_0087,within-group subordinate,within-group subordinate,58,23,35,23,44,46,67,1,99999,487,624,354,0.425904317386231,0,0,NA,NA,none,hothiphop.parents,hot.parents
2019,1,WCR2019_0741,3,WCR2019_0223,WCR2019_0088,within-group subordinate,within-group subordinate,62,29,33,23,40,52,69,1,99999,487,643,379,0.425904317386231,0,0,NA,NA,none,hothiphop.parents,hot.parents
2019,1,WCR2019_0742,1,WCR2019_0223,WCR2019_0087,within-group subordinate,within-group subordinate,61,24,37,25,42,49,66,1,99999,476,616,350,0.378443113772455,0,0,NA,NA,none,hothiphop.parents,hot.parents
2019,1,WCR2019_0742,2,WCR2019_0440,WCR2019_0087,within-group subordinate,within-group subordinate,69,29,40,26,42,55,71,1,99999,555,616,409,0.378443113772455,0,0,NA,NA,none,hothiphop.parents,hot.parents
2019,1,WCR2019_0742,3,WCR2019_0223,WCR2019_0061,within-group subordinate,within-group subordinate,70,37,33,25,37,62,74,1,99999,476,741,415,0.378443113772455,0,0,NA,NA,none,hothiphop.parents,hot.parents
2019,1,WCR2019_0744,1,WCR2019_0440,WCR2019_0122,within-group subordinate,within-group subordinate,43,27,16,12,8,39,35,1,99999,566,843,560,0.472514619883041,0,0,NA,NA,none,hothiphop.parents,hot.parents
2019,1,WCR2019_0744,2,WCR2019_0223,WCR2019_0088,within-group subordinate,within-group subordinate,45,30,15,13,14,43,44,1,99999,485,644,379,0.472514619883041,0,0,NA,NA,none,hothiphop.parents,hot.parents
2019,1,WCR2019_0744,3,WCR2019_0223,WCR2019_0122,within-group subordinate,within-group subordinate,45,30,15,13,8,43,38,1,99999,485,843,478,0.472514619883041,0,0,NA,NA,none,hothiphop.parents,hot.parents
2019,1,WCR2019_0745,1,WCR2019_0223,WCR2019_0327,within-group subordinate,within-group subordinate,56,31,25,21,17,52,48,1,99999,488,825,474,0.4,0,0,NA,NA,none,hothiphop.parents,hot.parents
2019,1,WCR2019_0745,2,WCR2019_0223,WCR2019_0088,within-group subordinate,within-group subordinate,56,28,28,21,33,49,61,1,99999,488,642,381,0.4,0,0,NA,NA,none,hothiphop.parents,hot.parents
2019,1,WCR2019_0745,3,WCR2019_0223,WCR2019_0161,within-group subordinate,within-group subordinate,57,33,24,21,19,54,52,1,99999,488,805,469,0.4,0,0,NA,NA,none,hothiphop.parents,hot.parents
2019,1,WCR2019_0786,1,WCR2019_0440,WCR2019_0216,within-group subordinate,within-group subordinate,53,31,22,22,1,53,32,1,99999,568,852,565,0.37995337995338,0,0,NA,NA,none,hothiphop.parents,hot.parents
2019,1,WCR2019_0786,2,WCR2019_0223,WCR2019_0216,within-group subordinate,within-group subordinate,55,30,25,24,1,54,31,1,99999,489,852,488,0.37995337995338,0,0,NA,NA,none,hothiphop.parents,hot.parents
2019,1,WCR2019_0786,3,WCR2019_0223,WCR2019_0087,within-group subordinate,within-group subordinate,55,23,32,24,38,47,61,1,99999,489,625,356,0.37995337995338,0,0,NA,NA,none,hothiphop.parents,hot.parents
2019,1,WCR2019_0787,1,WCR2019_0223,WCR2019_0461,within-group subordinate,within-group subordinate,49,25,24,23,5,48,30,1,99999,486,849,485,0.373974208675264,0,0,NA,NA,none,hothiphop.parents,hot.parents
2019,1,WCR2019_0787,2,WCR2019_0223,WCR2019_0087,within-group subordinate,within-group subordinate,57,24,33,23,39,47,63,1,99999,486,624,355,0.373974208675264,0,0,NA,NA,none,hothiphop.parents,hot.parents
2019,1,WCR2019_0787,3,WCR2019_0223,WCR2019_0327,within-group subordinate,within-group subordinate,61,29,32,23,25,52,54,1,99999,486,822,471,0.373974208675264,0,0,NA,NA,none,hothiphop.parents,hot.parents
2019,1,WCR2019_0789,1,WCR2019_0421,WCR2019_0548,within-group subordinate,within-group subordinate,5,0,5,2,3,2,3,1,99999,856,850,849,0.417736289381564,0,0,NA,NA,none,hothiphop.parents,hot.parents
2019,1,WCR2019_0789,2,WCR2019_0223,WCR2019_0088,within-group subordinate,within-group subordinate,48,30,18,16,21,46,51,1,99999,486,644,379,0.417736289381564,0,0,NA,NA,none,hothiphop.parents,hot.parents
2019,1,WCR2019_0789,3,WCR2019_0223,WCR2019_0327,within-group subordinate,within-group subordinate,54,30,24,16,22,46,52,1,99999,486,826,471,0.417736289381564,0,0,NA,NA,none,hothiphop.parents,hot.parents
2019,1,WCR2019_0790,1,WCR2019_0223,WCR2019_0087,within-group subordinate,within-group subordinate,68,24,44,31,54,55,78,1,99999,487,626,355,0.351981351981352,0,0,NA,NA,none,hothiphop.parents,hot.parents
2019,1,WCR2019_0790,2,WCR2019_0223,WCR2019_0061,within-group subordinate,within-group subordinate,69,30,39,31,45,61,75,1,99999,487,761,425,0.351981351981352,0,0,NA,NA,none,hothiphop.parents,hot.parents
2019,1,WCR2019_0790,3,WCR2019_0223,WCR2019_0073,within-group subordinate,within-group subordinate,74,32,42,31,47,63,79,1,99999,487,786,436,0.351981351981352,0,0,NA,NA,none,hothiphop.parents,hot.parents
2019,1,WCR2019_0791,1,WCR2019_0440,WCR2019_0150,within-group subordinate,within-group subordinate,54,31,23,22,3,53,34,1,99999,568,858,568,0.432400932400932,0,0,NA,NA,none,hothiphop.parents,hot.parents
2019,1,WCR2019_0791,2,WCR2019_0223,WCR2019_0327,within-group subordinate,within-group subordinate,57,35,22,22,13,57,48,1,99999,488,827,473,0.432400932400932,0,0,NA,NA,none,hothiphop.parents,hot.parents
2019,1,WCR2019_0791,3,WCR2019_0223,WCR2019_0061,within-group subordinate,within-group subordinate,57,31,26,22,28,53,59,1,99999,488,760,425,0.432400932400932,0,0,NA,NA,none,hothiphop.parents,hot.parents
2019,1,WCR2019_0792,1,WCR2019_0223,WCR2019_0087,within-group subordinate,within-group subordinate,57,20,37,26,43,46,63,1,99999,488,626,355,0.359720605355064,0,0,NA,NA,none,hothiphop.parents,hot.parents
2019,1,WCR2019_0792,2,WCR2019_0223,WCR2019_0061,within-group subordinate,within-group subordinate,65,25,40,26,46,51,71,1,99999,488,761,425,0.359720605355064,0,0,NA,NA,none,hothiphop.parents,hot.parents
2019,1,WCR2019_0792,3,WCR2019_0223,WCR2019_0075,within-group subordinate,within-group subordinate,71,33,38,26,61,59,94,1,99999,488,749,418,0.359720605355064,0,0,NA,NA,none,hothiphop.parents,hot.parents
2019,1,WCR2019_0793,1,WCR2019_0223,WCR2019_0088,within-group subordinate,within-group subordinate,55,36,19,13,18,49,54,1,99999,483,641,377,0.525821596244131,0,0,NA,NA,none,hothiphop.parents,hot.parents
2019,1,WCR2019_0793,2,WCR2019_0223,WCR2019_0061,within-group subordinate,within-group subordinate,58,37,21,13,24,50,61,1,99999,483,755,421,0.525821596244131,0,0,NA,NA,none,hothiphop.parents,hot.parents
2019,1,WCR2019_0793,3,WCR2019_0223,WCR2019_0075,within-group subordinate,within-group subordinate,63,48,15,13,19,61,67,1,99999,483,742,413,0.525821596244131,0,0,NA,NA,none,hothiphop.parents,hot.parents
2019,1,WCR2019_0794,1,WCR2019_0223,WCR2019_0087,within-group subordinate,within-group subordinate,68,24,44,33,43,57,67,1,99999,486,626,356,0.357894736842105,0,0,NA,NA,none,hothiphop.parents,hot.parents
2019,1,WCR2019_0794,2,WCR2019_0223,WCR2019_0061,within-group subordinate,within-group subordinate,69,27,42,33,44,60,71,1,99999,486,757,423,0.357894736842105,0,0,NA,NA,none,hothiphop.parents,hot.parents
2019,1,WCR2019_0794,3,WCR2019_0223,WCR2019_0073,within-group subordinate,within-group subordinate,74,30,44,33,45,63,75,1,99999,486,783,435,0.357894736842105,0,0,NA,NA,none,hothiphop.parents,hot.parents
2019,1,WCR2019_0795,1,WCR2019_0223,WCR2019_0216,within-group subordinate,within-group subordinate,57,31,26,23,4,54,35,1,99999,489,851,488,0.364060676779463,0,0,NA,NA,none,hothiphop.parents,hot.parents
2019,1,WCR2019_0795,2,WCR2019_0440,WCR2019_0216,within-group subordinate,within-group subordinate,63,34,29,28,4,62,38,1,99999,567,851,564,0.364060676779463,0,0,NA,NA,none,hothiphop.parents,hot.parents
2019,1,WCR2019_0795,3,WCR2019_0223,WCR2019_0327,within-group subordinate,within-group subordinate,66,38,28,23,27,61,65,1,99999,489,826,474,0.364060676779463,0,0,NA,NA,none,hothiphop.parents,hot.parents
2019,1,WCR2019_0796,1,WCR2019_0223,WCR2019_0087,within-group subordinate,within-group subordinate,65,24,41,28,45,52,69,1,99999,485,622,352,0.365339578454333,0,0,NA,NA,none,hothiphop.parents,hot.parents
2019,1,WCR2019_0796,2,WCR2019_0223,WCR2019_0061,within-group subordinate,within-group subordinate,68,32,36,28,41,60,73,1,99999,485,756,422,0.365339578454333,0,0,NA,NA,none,hothiphop.parents,hot.parents
2019,1,WCR2019_0796,3,WCR2019_0223,WCR2019_0327,within-group subordinate,within-group subordinate,68,32,36,28,29,60,61,1,99999,485,824,470,0.365339578454333,0,0,NA,NA,none,hothiphop.parents,hot.parents
2019,1,WCR2019_0797,1,WCR2019_0223,WCR2019_0327,within-group subordinate,within-group subordinate,53,35,18,12,12,47,47,1,99999,486,819,471,0.430588235294118,0,0,NA,NA,none,hothiphop.parents,hot.parents
2019,1,WCR2019_0797,2,WCR2019_0223,WCR2019_0088,within-group subordinate,within-group subordinate,53,26,27,12,29,38,55,1,99999,486,640,378,0.430588235294118,0,0,NA,NA,none,hothiphop.parents,hot.parents
2019,1,WCR2019_0797,3,WCR2019_0223,WCR2019_0087,within-group subordinate,within-group subordinate,55,29,26,12,42,41,71,1,99999,486,621,353,0.430588235294118,0,0,NA,NA,none,hothiphop.parents,hot.parents
2019,1,WCR2019_0798,1,WCR2019_0223,WCR2019_0087,within-group subordinate,within-group subordinate,66,23,43,30,48,53,71,1,99999,487,626,355,0.342657342657343,0,0,NA,NA,none,hothiphop.parents,hot.parents
2019,1,WCR2019_0798,2,WCR2019_0223,WCR2019_0327,within-group subordinate,within-group subordinate,70,31,39,30,36,61,67,1,99999,487,828,473,0.342657342657343,0,0,NA,NA,none,hothiphop.parents,hot.parents
2019,1,WCR2019_0798,3,WCR2019_0223,WCR2019_0445,within-group subordinate,within-group subordinate,74,25,49,30,55,55,80,1,99999,487,851,486,0.342657342657343,0,0,NA,NA,none,hothiphop.parents,hot.parents
2019,1,WCR2019_0799,1,WCR2019_0223,WCR2019_0075,within-group subordinate,within-group subordinate,51,26,25,20,34,46,60,1,99999,486,741,416,0.414806110458284,0,0,NA,NA,none,hothiphop.parents,hot.parents
2019,1,WCR2019_0799,2,WCR2019_0223,WCR2019_0161,within-group subordinate,within-group subordinate,53,26,27,20,27,46,53,1,99999,486,802,467,0.414806110458284,0,0,NA,NA,none,hothiphop.parents,hot.parents
2019,1,WCR2019_0799,3,WCR2019_0223,WCR2019_0061,within-group subordinate,within-group subordinate,57,26,31,20,36,46,62,1,99999,486,754,423,0.414806110458284,0,0,NA,NA,none,hothiphop.parents,hot.parents
2019,1,WCR2019_0800,1,WCR2019_0223,WCR2019_0088,within-group subordinate,within-group subordinate,52,23,29,18,40,41,63,1,99999,488,646,381,0.409090909090909,0,0,NA,NA,none,hothiphop.parents,hot.parents
2019,1,WCR2019_0800,2,WCR2019_0223,WCR2019_0475,within-group subordinate,within-group subordinate,54,35,19,18,1,53,36,1,99999,488,856,487,0.409090909090909,0,0,NA,NA,none,hothiphop.parents,hot.parents
2019,1,WCR2019_0800,3,WCR2019_0223,WCR2019_0327,within-group subordinate,within-group subordinate,54,29,25,18,19,47,48,1,99999,488,827,473,0.409090909090909,0,0,NA,NA,none,hothiphop.parents,hot.parents
2019,1,WCR2019_0801,1,WCR2019_0420,WCR2019_0405,within-group subordinate,within-group subordinate,0,0,0,0,0,0,0,1,99999,846,797,796,0.0472255017709563,0,0,NA,NA,none,hothiphop.parents,hot.parents
2019,1,WCR2019_0801,2,WCR2019_0474,WCR2019_0405,within-group subordinate,within-group subordinate,2,0,2,3,0,3,0,1,99999,727,797,684,0.0472255017709563,0,0,NA,NA,none,hothiphop.parents,hot.parents
2019,1,WCR2019_0801,3,WCR2019_0420,WCR2019_0518,within-group subordinate,within-group subordinate,3,1,2,0,2,1,3,1,99999,846,837,836,0.0472255017709563,0,0,NA,NA,none,hothiphop.parents,hot.parents
2019,1,WCR2019_0802,1,WCR2019_0479,WCR2019_0398,within-group subordinate,within-group subordinate,3,2,1,1,0,3,2,1,99999,840,843,839,0.0556872037914692,0,0,NA,NA,none,hothiphop.parents,hot.parents
2019,1,WCR2019_0802,2,WCR2019_0252,WCR2019_0398,within-group subordinate,within-group subordinate,5,3,2,2,0,5,3,1,99999,841,843,840,0.0556872037914692,0,0,NA,NA,none,hothiphop.parents,hot.parents
2019,1,WCR2019_0802,3,WCR2019_0409,WCR2019_0398,within-group subordinate,within-group subordinate,5,3,2,2,0,5,3,1,99999,839,843,838,0.0556872037914692,0,0,NA,NA,none,hothiphop.parents,hot.parents
2019,1,WCR2019_0803,1,WCR2019_0420,WCR2019_0325,within-group subordinate,within-group subordinate,1,1,0,0,0,1,1,1,99999,800,795,794,0.16354556803995,0,0,NA,NA,none,hothiphop.parents,hot.parents
2019,1,WCR2019_0803,2,WCR2019_0474,WCR2019_0325,within-group subordinate,within-group subordinate,4,2,2,2,0,4,2,1,99999,683,795,679,0.16354556803995,0,0,NA,NA,none,hothiphop.parents,hot.parents
2019,1,WCR2019_0803,3,WCR2019_0535,WCR2019_0325,within-group subordinate,within-group subordinate,4,2,2,2,0,4,2,1,99999,796,795,790,0.16354556803995,0,0,NA,NA,none,hothiphop.parents,hot.parents
2019,1,WCR2019_0804,1,WCR2019_0223,WCR2019_0061,within-group subordinate,within-group subordinate,46,24,22,15,37,39,61,1,99999,489,762,426,0.409302325581395,0,0,NA,NA,none,hothiphop.parents,hot.parents
2019,1,WCR2019_0804,2,WCR2019_0223,WCR2019_0327,within-group subordinate,within-group subordinate,47,30,17,15,16,45,46,1,99999,489,829,474,0.409302325581395,0,0,NA,NA,none,hothiphop.parents,hot.parents
2019,1,WCR2019_0804,3,WCR2019_0223,WCR2019_0088,within-group subordinate,within-group subordinate,51,23,28,15,37,38,60,1,99999,489,646,381,0.409302325581395,0,0,NA,NA,none,hothiphop.parents,hot.parents
2019,1,WCR2019_0805,1,WCR2019_0337,WCR2019_0405,within-group subordinate,within-group subordinate,8,1,7,4,3,5,4,1,99999,847,801,798,0.455294117647059,0,0,NA,NA,none,hothiphop.parents,hot.parents
2019,1,WCR2019_0805,2,WCR2019_0337,WCR2019_0518,within-group subordinate,within-group subordinate,13,7,6,4,2,11,9,1,99999,847,839,836,0.455294117647059,0,0,NA,NA,none,hothiphop.parents,hot.parents
2019,1,WCR2019_0805,3,WCR2019_0337,WCR2019_0039,within-group subordinate,within-group subordinate,14,7,7,4,3,11,10,1,99999,847,828,825,0.455294117647059,0,0,NA,NA,none,hothiphop.parents,hot.parents
2019,1,WCR2019_0807,1,WCR2019_0223,WCR2019_0087,within-group subordinate,within-group subordinate,65,22,43,30,46,52,68,1,99999,487,619,354,0.34037558685446,0,0,NA,NA,none,hothiphop.parents,hot.parents
2019,1,WCR2019_0807,2,WCR2019_0223,WCR2019_0061,within-group subordinate,within-group subordinate,69,29,40,30,44,59,73,1,99999,487,754,424,0.34037558685446,0,0,NA,NA,none,hothiphop.parents,hot.parents
2019,1,WCR2019_0807,3,WCR2019_0223,WCR2019_0073,within-group subordinate,within-group subordinate,73,31,42,30,45,61,76,1,99999,487,780,436,0.34037558685446,0,0,NA,NA,none,hothiphop.parents,hot.parents
2019,1,WCR2019_0811,1,WCR2019_0440,WCR2019_0122,within-group subordinate,within-group subordinate,49,16,33,22,25,38,41,1,99999,567,845,561,0.401400233372229,0,0,NA,NA,none,hothiphop.parents,hot.parents
2019,1,WCR2019_0811,2,WCR2019_0223,WCR2019_0061,within-group subordinate,within-group subordinate,54,29,25,20,30,49,59,1,99999,487,759,424,0.401400233372229,0,0,NA,NA,none,hothiphop.parents,hot.parents
2019,1,WCR2019_0811,3,WCR2019_0223,WCR2019_0088,within-group subordinate,within-group subordinate,55,26,29,20,29,46,55,1,99999,487,643,379,0.401400233372229,0,0,NA,NA,none,hothiphop.parents,hot.parents
2019,1,WCR2019_0818,1,WCR2019_0550,WCR2019_0327,within-group subordinate,within-group subordinate,31,15,16,12,11,27,26,1,99999,850,825,819,0.175233644859813,0,0,NA,NA,none,hothiphop.parents,hot.parents
2019,1,WCR2019_0818,2,WCR2019_0474,WCR2019_0161,within-group subordinate,within-group subordinate,33,18,15,10,13,28,31,1,99999,735,806,692,0.175233644859813,0,0,NA,NA,none,hothiphop.parents,hot.parents
2019,1,WCR2019_0818,3,WCR2019_0550,WCR2019_0122,within-group subordinate,within-group subordinate,34,17,17,12,9,29,26,1,99999,850,844,838,0.175233644859813,0,0,NA,NA,none,hothiphop.parents,hot.parents
2019,1,WCR2019_0820,1,WCR2019_0474,WCR2019_0047,within-group subordinate,within-group subordinate,4,2,2,0,2,2,4,1,99999,736,856,735,0.271878646441074,0,0,NA,NA,none,hothiphop.parents,hot.parents
2019,1,WCR2019_0820,2,WCR2019_0338,WCR2019_0047,within-group subordinate,within-group subordinate,6,3,3,3,2,6,5,1,99999,853,856,852,0.271878646441074,0,0,NA,NA,none,hothiphop.parents,hot.parents
2019,1,WCR2019_0820,3,WCR2019_0523,WCR2019_0047,within-group subordinate,within-group subordinate,6,2,4,2,2,4,4,1,99999,849,856,848,0.271878646441074,0,0,NA,NA,none,hothiphop.parents,hot.parents
2019,1,WCR2019_0821,1,WCR2019_0223,WCR2019_0087,within-group subordinate,within-group subordinate,55,19,36,29,39,48,58,1,99999,486,624,354,0.357142857142857,0,0,NA,NA,none,hothiphop.parents,hot.parents
2019,1,WCR2019_0821,2,WCR2019_0223,WCR2019_0327,within-group subordinate,within-group subordinate,65,29,36,29,27,58,56,1,99999,486,823,471,0.357142857142857,0,0,NA,NA,none,hothiphop.parents,hot.parents
2019,1,WCR2019_0821,3,WCR2019_0223,WCR2019_0075,within-group subordinate,within-group subordinate,67,29,38,29,46,58,75,1,99999,486,745,416,0.357142857142857,0,0,NA,NA,none,hothiphop.parents,hot.parents
2019,1,WCR2019_0824,1,WCR2019_0223,WCR2019_0061,within-group subordinate,within-group subordinate,52,24,28,23,32,47,56,1,99999,487,757,424,0.398830409356725,0,0,NA,NA,none,hothiphop.parents,hot.parents
2019,1,WCR2019_0824,2,WCR2019_0440,WCR2019_0122,within-group subordinate,within-group subordinate,54,25,29,18,25,43,50,1,99999,567,843,561,0.398830409356725,0,0,NA,NA,none,hothiphop.parents,hot.parents
2019,1,WCR2019_0824,3,WCR2019_0223,WCR2019_0087,within-group subordinate,within-group subordinate,56,21,35,23,46,44,67,1,99999,487,624,354,0.398830409356725,0,0,NA,NA,none,hothiphop.parents,hot.parents
2019,1,WCR2019_0825,1,WCR2019_0223,WCR2019_0087,within-group subordinate,within-group subordinate,64,23,41,32,42,55,65,1,99999,488,625,355,0.40303738317757,0,0,NA,NA,none,hothiphop.parents,hot.parents
2019,1,WCR2019_0825,2,WCR2019_0440,WCR2019_0087,within-group subordinate,within-group subordinate,69,24,45,27,42,51,66,1,99999,568,625,413,0.40303738317757,0,0,NA,NA,none,hothiphop.parents,hot.parents
2019,1,WCR2019_0825,3,WCR2019_0440,WCR2019_0516,within-group subordinate,within-group subordinate,70,41,29,27,3,68,44,1,99999,568,848,564,0.40303738317757,0,0,NA,NA,none,hothiphop.parents,hot.parents
2019,1,WCR2019_0826,1,WCR2019_0223,WCR2019_0087,within-group subordinate,within-group subordinate,59,19,40,25,53,44,72,1,99999,477,619,349,0.343601895734597,0,0,NA,NA,none,hothiphop.parents,hot.parents
2019,1,WCR2019_0826,2,WCR2019_0223,WCR2019_0061,within-group subordinate,within-group subordinate,60,25,35,25,42,50,67,1,99999,477,750,416,0.343601895734597,0,0,NA,NA,none,hothiphop.parents,hot.parents
2019,1,WCR2019_0826,3,WCR2019_0223,WCR2019_0073,within-group subordinate,within-group subordinate,65,25,40,25,51,50,76,1,99999,477,776,428,0.343601895734597,0,0,NA,NA,none,hothiphop.parents,hot.parents
2019,1,WCR2019_0827,1,WCR2019_0474,WCR2019_0516,within-group subordinate,within-group subordinate,9,3,6,4,4,7,7,1,99999,734,847,726,0.444444444444444,0,0,NA,NA,none,hothiphop.parents,hot.parents
2019,1,WCR2019_0827,2,WCR2019_0334,WCR2019_0516,within-group subordinate,within-group subordinate,11,5,6,2,4,7,9,1,99999,853,847,845,0.444444444444444,0,0,NA,NA,none,hothiphop.parents,hot.parents
2019,1,WCR2019_0827,3,WCR2019_0479,WCR2019_0516,within-group subordinate,within-group subordinate,12,7,5,1,4,8,11,1,99999,851,847,843,0.444444444444444,0,0,NA,NA,none,hothiphop.parents,hot.parents
2019,1,WCR2019_0829,1,WCR2019_0223,WCR2019_0087,within-group subordinate,within-group subordinate,60,23,37,27,43,50,66,1,99999,488,626,355,0.367869615832363,0,0,NA,NA,none,hothiphop.parents,hot.parents
2019,1,WCR2019_0829,2,WCR2019_0440,WCR2019_0327,within-group subordinate,within-group subordinate,69,32,37,28,32,60,64,1,99999,568,828,548,0.367869615832363,0,0,NA,NA,none,hothiphop.parents,hot.parents
2019,1,WCR2019_0829,3,WCR2019_0223,WCR2019_0327,within-group subordinate,within-group subordinate,73,37,36,27,32,64,69,1,99999,488,828,473,0.367869615832363,0,0,NA,NA,none,hothiphop.parents,hot.parents
2019,1,WCR2019_0831,1,WCR2019_0223,WCR2019_0122,within-group subordinate,within-group subordinate,53,27,26,21,19,48,46,1,99999,484,842,477,0.441451990632318,0,0,NA,NA,none,hothiphop.parents,hot.parents
2019,1,WCR2019_0831,2,WCR2019_0223,WCR2019_0088,within-group subordinate,within-group subordinate,56,27,29,21,26,48,53,1,99999,484,644,380,0.441451990632318,0,0,NA,NA,none,hothiphop.parents,hot.parents
2019,1,WCR2019_0831,3,WCR2019_0440,WCR2019_0327,within-group subordinate,within-group subordinate,59,31,28,26,20,57,51,1,99999,565,823,545,0.441451990632318,0,0,NA,NA,none,hothiphop.parents,hot.parents
2019,1,WCR2019_0832,1,WCR2019_0524,WCR2019_0451,within-group subordinate,within-group subordinate,5,0,5,3,2,3,2,1,99999,844,852,841,0.40233918128655,0,0,NA,NA,none,hothiphop.parents,hot.parents
2019,1,WCR2019_0832,2,WCR2019_0223,WCR2019_0451,within-group subordinate,within-group subordinate,49,32,17,17,2,49,34,1,99999,488,852,486,0.40233918128655,0,0,NA,NA,none,hothiphop.parents,hot.parents
2019,1,WCR2019_0832,3,WCR2019_0524,WCR2019_0327,within-group subordinate,within-group subordinate,51,39,12,3,10,42,49,1,99999,844,824,815,0.40233918128655,0,0,NA,NA,none,hothiphop.parents,hot.parents
2019,1,WCR2019_0833,1,WCR2019_0440,WCR2019_0122,within-group subordinate,within-group subordinate,58,26,32,23,16,49,42,1,99999,567,843,561,0.44093567251462,0,0,NA,NA,none,hothiphop.parents,hot.parents
2019,1,WCR2019_0833,2,WCR2019_0223,WCR2019_0088,within-group subordinate,within-group subordinate,59,30,29,27,27,57,57,1,99999,489,644,381,0.44093567251462,0,0,NA,NA,none,hothiphop.parents,hot.parents
2019,1,WCR2019_0833,3,WCR2019_0223,WCR2019_0327,within-group subordinate,within-group subordinate,60,30,30,27,15,57,45,1,99999,489,824,474,0.44093567251462,0,0,NA,NA,none,hothiphop.parents,hot.parents
2019,1,WCR2019_0834,1,WCR2019_0223,WCR2019_0087,within-group subordinate,within-group subordinate,67,22,45,24,53,46,75,1,99999,488,626,355,0.337995337995338,0,0,NA,NA,none,hothiphop.parents,hot.parents
2019,1,WCR2019_0834,2,WCR2019_0223,WCR2019_0161,within-group subordinate,within-group subordinate,74,35,39,24,46,59,81,1,99999,488,808,469,0.337995337995338,0,0,NA,NA,none,hothiphop.parents,hot.parents
2019,1,WCR2019_0834,3,WCR2019_0223,WCR2019_0075,within-group subordinate,within-group subordinate,77,36,41,24,57,60,93,1,99999,488,748,418,0.337995337995338,0,0,NA,NA,none,hothiphop.parents,hot.parents
2019,1,WCR2019_0836,1,WCR2019_0223,WCR2019_0088,within-group subordinate,within-group subordinate,48,22,26,20,14,42,36,1,99999,468,626,366,0.478941034897714,0,0,NA,NA,none,hothiphop.parents,hot.parents
2019,1,WCR2019_0836,2,WCR2019_0223,WCR2019_0327,within-group subordinate,within-group subordinate,49,26,23,20,5,46,31,1,99999,468,801,453,0.478941034897714,0,0,NA,NA,none,hothiphop.parents,hot.parents
2019,1,WCR2019_0836,3,WCR2019_0223,WCR2019_0161,within-group subordinate,within-group subordinate,50,29,21,20,7,49,36,1,99999,468,781,449,0.478941034897714,0,0,NA,NA,none,hothiphop.parents,hot.parents
2019,1,WCR2019_0837,1,WCR2019_0223,WCR2019_0087,within-group subordinate,within-group subordinate,57,19,38,26,46,45,65,1,99999,487,626,356,0.361726954492415,0,0,NA,NA,none,hothiphop.parents,hot.parents
2019,1,WCR2019_0837,2,WCR2019_0223,WCR2019_0061,within-group subordinate,within-group subordinate,59,22,37,26,41,48,63,1,99999,487,759,424,0.361726954492415,0,0,NA,NA,none,hothiphop.parents,hot.parents
2019,1,WCR2019_0837,3,WCR2019_0223,WCR2019_0073,within-group subordinate,within-group subordinate,64,28,36,26,47,54,75,1,99999,487,785,436,0.361726954492415,0,0,NA,NA,none,hothiphop.parents,hot.parents
2019,1,WCR2019_0838,1,WCR2019_0440,WCR2019_0327,within-group subordinate,within-group subordinate,55,33,22,19,18,52,51,1,99999,561,818,541,0.414605418138987,0,0,NA,NA,none,hothiphop.parents,hot.parents
2019,1,WCR2019_0838,2,WCR2019_0223,WCR2019_0327,within-group subordinate,within-group subordinate,56,28,28,26,18,54,46,1,99999,481,818,466,0.414605418138987,0,0,NA,NA,none,hothiphop.parents,hot.parents
2019,1,WCR2019_0838,3,WCR2019_0440,WCR2019_0161,within-group subordinate,within-group subordinate,57,26,31,19,27,45,53,1,99999,561,799,538,0.414605418138987,0,0,NA,NA,none,hothiphop.parents,hot.parents
2019,1,WCR2019_0839,1,WCR2019_0223,WCR2019_0122,within-group subordinate,within-group subordinate,39,22,17,14,13,36,35,1,99999,487,845,480,0.388564760793466,0,0,NA,NA,none,hothiphop.parents,hot.parents
2019,1,WCR2019_0839,2,WCR2019_0223,WCR2019_0327,within-group subordinate,within-group subordinate,40,23,17,14,12,37,35,1,99999,487,826,472,0.388564760793466,0,0,NA,NA,none,hothiphop.parents,hot.parents
2019,1,WCR2019_0839,3,WCR2019_0223,WCR2019_0075,within-group subordinate,within-group subordinate,43,27,16,14,22,41,49,1,99999,487,747,417,0.388564760793466,0,0,NA,NA,none,hothiphop.parents,hot.parents
2019,1,WCR2019_0840,1,WCR2019_0223,WCR2019_0279,within-group subordinate,within-group subordinate,43,16,27,26,2,42,18,1,99999,483,845,482,0.363529411764706,0,0,NA,NA,none,hothiphop.parents,hot.parents
2019,1,WCR2019_0840,2,WCR2019_0223,WCR2019_0087,within-group subordinate,within-group subordinate,55,18,37,26,51,44,69,1,99999,483,618,351,0.363529411764706,0,0,NA,NA,none,hothiphop.parents,hot.parents
2019,1,WCR2019_0840,3,WCR2019_0223,WCR2019_0327,within-group subordinate,within-group subordinate,59,25,34,26,22,51,47,1,99999,483,820,469,0.363529411764706,0,0,NA,NA,none,hothiphop.parents,hot.parents
2019,1,WCR2019_0841,1,WCR2019_0223,WCR2019_0461,within-group subordinate,within-group subordinate,50,26,24,23,3,49,29,1,99999,489,855,488,0.380675203725262,0,0,NA,NA,none,hothiphop.parents,hot.parents
2019,1,WCR2019_0841,2,WCR2019_0223,WCR2019_0087,within-group subordinate,within-group subordinate,53,22,31,23,32,45,54,1,99999,489,626,356,0.380675203725262,0,0,NA,NA,none,hothiphop.parents,hot.parents
2019,1,WCR2019_0841,3,WCR2019_0223,WCR2019_0061,within-group subordinate,within-group subordinate,58,28,30,23,39,51,67,1,99999,489,761,426,0.380675203725262,0,0,NA,NA,none,hothiphop.parents,hot.parents
2019,1,WCR2019_0842,1,WCR2019_0223,WCR2019_0087,within-group subordinate,within-group subordinate,60,22,38,26,44,48,66,1,99999,471,611,344,0.376950780312125,0,0,NA,NA,none,hothiphop.parents,hot.parents
2019,1,WCR2019_0842,2,WCR2019_0223,WCR2019_0061,within-group subordinate,within-group subordinate,63,27,36,26,41,53,68,1,99999,471,737,409,0.376950780312125,0,0,NA,NA,none,hothiphop.parents,hot.parents
2019,1,WCR2019_0842,3,WCR2019_0223,WCR2019_0327,within-group subordinate,within-group subordinate,68,34,34,26,19,60,53,1,99999,471,802,456,0.376950780312125,0,0,NA,NA,none,hothiphop.parents,hot.parents
2019,1,WCR2019_0844,1,WCR2019_0223,WCR2019_0087,within-group subordinate,within-group subordinate,64,23,41,29,43,52,66,1,99999,467,605,342,0.365408038976857,0,0,NA,NA,none,hothiphop.parents,hot.parents
2019,1,WCR2019_0844,2,WCR2019_0585,WCR2019_0122,within-group subordinate,within-group subordinate,67,35,32,2,31,37,66,1,99999,821,810,810,0.365408038976857,0,0,NA,NA,none,hothiphop.parents,hot.parents
2019,1,WCR2019_0844,3,WCR2019_0585,WCR2019_0327,within-group subordinate,within-group subordinate,71,43,28,2,26,45,69,1,99999,821,791,791,0.365408038976857,0,0,NA,NA,none,hothiphop.parents,hot.parents
2019,1,WCR2019_0845,1,WCR2019_0223,WCR2019_0088,within-group subordinate,within-group subordinate,46,25,21,20,24,45,49,1,99999,488,643,380,0.408878504672897,0,0,NA,NA,none,hothiphop.parents,hot.parents
2019,1,WCR2019_0845,2,WCR2019_0223,WCR2019_0061,within-group subordinate,within-group subordinate,53,25,28,20,31,45,56,1,99999,488,758,425,0.408878504672897,0,0,NA,NA,none,hothiphop.parents,hot.parents
2019,1,WCR2019_0845,3,WCR2019_0223,WCR2019_0075,within-group subordinate,within-group subordinate,54,29,25,20,26,49,55,1,99999,488,746,418,0.408878504672897,0,0,NA,NA,none,hothiphop.parents,hot.parents
2019,1,WCR2019_0847,1,WCR2019_0165,WCR2019_0461,within-group subordinate,within-group subordinate,27,12,15,13,2,25,14,1,99999,834,835,830,0.461263408820024,0,0,NA,NA,none,hothiphop.parents,hot.parents
2019,1,WCR2019_0847,2,WCR2019_0493,WCR2019_0461,within-group subordinate,within-group subordinate,30,20,10,8,2,28,22,1,99999,833,835,830,0.461263408820024,0,0,NA,NA,none,hothiphop.parents,hot.parents
2019,1,WCR2019_0847,3,WCR2019_0252,WCR2019_0461,within-group subordinate,within-group subordinate,30,19,11,10,2,29,21,1,99999,836,835,832,0.461263408820024,0,0,NA,NA,none,hothiphop.parents,hot.parents
2019,1,WCR2019_0848,1,WCR2019_0440,WCR2019_0088,within-group subordinate,within-group subordinate,42,22,20,20,5,42,27,1,99999,563,641,428,0.379107981220657,0,0,NA,NA,none,hothiphop.parents,hot.parents
2019,1,WCR2019_0848,2,WCR2019_0440,WCR2019_0122,within-group subordinate,within-group subordinate,42,21,21,20,3,41,24,1,99999,563,841,558,0.379107981220657,0,0,NA,NA,none,hothiphop.parents,hot.parents
2019,1,WCR2019_0848,3,WCR2019_0191,WCR2019_0088,within-group subordinate,within-group subordinate,45,27,18,22,5,49,32,1,99999,644,641,472,0.379107981220657,0,0,NA,NA,none,hothiphop.parents,hot.parents
2019,1,WCR2019_0849,1,WCR2019_0223,WCR2019_0014,within-group subordinate,within-group subordinate,40,17,23,20,6,37,23,1,99999,489,858,488,0.357392316647264,0,0,NA,NA,none,hothiphop.parents,hot.parents
2019,1,WCR2019_0849,2,WCR2019_0223,WCR2019_0061,within-group subordinate,within-group subordinate,42,20,22,20,20,40,40,1,99999,489,761,426,0.357392316647264,0,0,NA,NA,none,hothiphop.parents,hot.parents
2019,1,WCR2019_0849,3,WCR2019_0345,WCR2019_0014,within-group subordinate,within-group subordinate,44,23,21,15,6,38,29,1,99999,846,858,845,0.357392316647264,0,0,NA,NA,none,hothiphop.parents,hot.parents
2019,1,WCR2019_0851,1,WCR2019_0223,WCR2019_0087,within-group subordinate,within-group subordinate,62,23,39,28,44,51,67,1,99999,489,626,356,0.419091967403958,0,0,NA,NA,none,hothiphop.parents,hot.parents
2019,1,WCR2019_0851,2,WCR2019_0223,WCR2019_0327,within-group subordinate,within-group subordinate,69,34,35,28,25,62,59,1,99999,489,828,474,0.419091967403958,0,0,NA,NA,none,hothiphop.parents,hot.parents
2019,1,WCR2019_0851,3,WCR2019_0223,WCR2019_0061,within-group subordinate,within-group subordinate,72,32,40,28,41,60,73,1,99999,489,761,426,0.419091967403958,0,0,NA,NA,none,hothiphop.parents,hot.parents
2019,1,WCR2019_0853,1,WCR2019_0440,WCR2019_0122,within-group subordinate,within-group subordinate,58,21,37,23,26,44,47,1,99999,566,843,560,0.421052631578947,0,0,NA,NA,none,hothiphop.parents,hot.parents
2019,1,WCR2019_0853,2,WCR2019_0440,WCR2019_0327,within-group subordinate,within-group subordinate,61,32,29,23,23,55,55,1,99999,566,824,546,0.421052631578947,0,0,NA,NA,none,hothiphop.parents,hot.parents
2019,1,WCR2019_0853,3,WCR2019_0223,WCR2019_0088,within-group subordinate,within-group subordinate,61,28,33,23,34,51,62,1,99999,485,642,378,0.421052631578947,0,0,NA,NA,none,hothiphop.parents,hot.parents
2019,1,WCR2019_0854,1,WCR2019_0223,WCR2019_0087,within-group subordinate,within-group subordinate,70,23,47,34,51,57,74,1,99999,487,625,354,0.346153846153846,0,0,NA,NA,none,hothiphop.parents,hot.parents
2019,1,WCR2019_0854,2,WCR2019_0223,WCR2019_0073,within-group subordinate,within-group subordinate,74,32,42,34,43,66,75,1,99999,487,786,436,0.346153846153846,0,0,NA,NA,none,hothiphop.parents,hot.parents
2019,1,WCR2019_0854,3,WCR2019_0223,WCR2019_0061,within-group subordinate,within-group subordinate,74,30,44,34,44,64,74,1,99999,487,760,424,0.346153846153846,0,0,NA,NA,none,hothiphop.parents,hot.parents
2019,1,WCR2019_0855,1,WCR2019_0223,WCR2019_0061,within-group subordinate,within-group subordinate,56,27,29,29,18,56,45,1,99999,473,742,414,0.424278846153846,0,0,NA,NA,none,hothiphop.parents,hot.parents
2019,1,WCR2019_0855,2,WCR2019_0223,WCR2019_0327,within-group subordinate,within-group subordinate,60,30,30,29,11,59,41,1,99999,473,801,458,0.424278846153846,0,0,NA,NA,none,hothiphop.parents,hot.parents
2019,1,WCR2019_0855,3,WCR2019_0223,WCR2019_0088,within-group subordinate,within-group subordinate,60,27,33,29,26,56,53,1,99999,473,633,374,0.424278846153846,0,0,NA,NA,none,hothiphop.parents,hot.parents
2019,1,WCR2019_0856,1,WCR2019_0223,WCR2019_0061,within-group subordinate,within-group subordinate,38,12,26,21,25,33,37,1,99999,481,748,419,0.336094674556213,0,0,NA,NA,none,hothiphop.parents,hot.parents
2019,1,WCR2019_0856,2,WCR2019_0223,WCR2019_0122,within-group subordinate,within-group subordinate,40,16,24,21,8,37,24,1,99999,481,834,475,0.336094674556213,0,0,NA,NA,none,hothiphop.parents,hot.parents
2019,1,WCR2019_0856,3,WCR2019_0223,WCR2019_0088,within-group subordinate,within-group subordinate,40,14,26,21,16,35,30,1,99999,481,635,375,0.336094674556213,0,0,NA,NA,none,hothiphop.parents,hot.parents
2019,1,WCR2019_0857,1,WCR2019_0223,WCR2019_0161,within-group subordinate,within-group subordinate,62,30,32,27,27,57,57,1,99999,488,807,469,0.393232205367561,0,0,NA,NA,none,hothiphop.parents,hot.parents
2019,1,WCR2019_0857,2,WCR2019_0223,WCR2019_0327,within-group subordinate,within-group subordinate,63,32,31,27,14,59,46,1,99999,488,826,473,0.393232205367561,0,0,NA,NA,none,hothiphop.parents,hot.parents
2019,1,WCR2019_0857,3,WCR2019_0223,WCR2019_0061,within-group subordinate,within-group subordinate,64,31,33,27,33,58,64,1,99999,488,759,425,0.393232205367561,0,0,NA,NA,none,hothiphop.parents,hot.parents
2019,1,WCR2019_0858,1,WCR2019_0223,WCR2019_0087,within-group subordinate,within-group subordinate,54,21,33,26,40,47,61,1,99999,487,625,355,0.372663551401869,0,0,NA,NA,none,hothiphop.parents,hot.parents
2019,1,WCR2019_0858,2,WCR2019_0223,WCR2019_0327,within-group subordinate,within-group subordinate,58,26,32,26,28,52,54,1,99999,487,825,472,0.372663551401869,0,0,NA,NA,none,hothiphop.parents,hot.parents
2019,1,WCR2019_0858,3,WCR2019_0223,WCR2019_0161,within-group subordinate,within-group subordinate,59,26,33,26,36,52,62,1,99999,487,807,469,0.372663551401869,0,0,NA,NA,none,hothiphop.parents,hot.parents
2019,1,WCR2019_0860,1,WCR2019_0223,WCR2019_0088,within-group subordinate,within-group subordinate,48,21,27,30,9,51,30,1,99999,485,640,380,0.351764705882353,0,0,NA,NA,none,hothiphop.parents,hot.parents
2019,1,WCR2019_0860,2,WCR2019_0223,WCR2019_0075,within-group subordinate,within-group subordinate,50,19,31,30,17,49,36,1,99999,485,742,416,0.351764705882353,0,0,NA,NA,none,hothiphop.parents,hot.parents
2019,1,WCR2019_0860,3,WCR2019_0223,WCR2019_0327,within-group subordinate,within-group subordinate,51,20,31,30,13,50,33,1,99999,485,819,470,0.351764705882353,0,0,NA,NA,none,hothiphop.parents,hot.parents
2019,1,WCR2019_0861,1,WCR2019_0223,WCR2019_0122,within-group subordinate,within-group subordinate,54,27,27,17,17,44,44,1,99999,484,840,477,0.40962441314554,0,0,NA,NA,none,hothiphop.parents,hot.parents
2019,1,WCR2019_0861,2,WCR2019_0440,WCR2019_0122,within-group subordinate,within-group subordinate,55,24,31,24,17,48,41,1,99999,563,840,557,0.40962441314554,0,0,NA,NA,none,hothiphop.parents,hot.parents
2019,1,WCR2019_0861,3,WCR2019_0223,WCR2019_0088,within-group subordinate,within-group subordinate,58,28,30,17,37,45,65,1,99999,484,642,378,0.40962441314554,0,0,NA,NA,none,hothiphop.parents,hot.parents
2019,1,WCR2019_0862,1,WCR2019_0223,WCR2019_0327,within-group subordinate,within-group subordinate,67,32,35,28,33,60,65,1,99999,486,820,472,0.390588235294118,0,0,NA,NA,none,hothiphop.parents,hot.parents
2019,1,WCR2019_0862,2,WCR2019_0223,WCR2019_0087,within-group subordinate,within-group subordinate,67,22,45,28,53,50,75,1,99999,486,619,354,0.390588235294118,0,0,NA,NA,none,hothiphop.parents,hot.parents
2019,1,WCR2019_0862,3,WCR2019_0223,WCR2019_0161,within-group subordinate,within-group subordinate,70,34,36,28,38,62,72,1,99999,486,800,467,0.390588235294118,0,0,NA,NA,none,hothiphop.parents,hot.parents
2019,1,WCR2019_0863,1,WCR2019_0223,WCR2019_0327,within-group subordinate,within-group subordinate,64,35,29,26,27,61,62,1,99999,488,827,473,0.396270396270396,0,0,NA,NA,none,hothiphop.parents,hot.parents
2019,1,WCR2019_0863,2,WCR2019_0223,WCR2019_0087,within-group subordinate,within-group subordinate,65,26,39,26,43,52,69,1,99999,488,626,355,0.396270396270396,0,0,NA,NA,none,hothiphop.parents,hot.parents
2019,1,WCR2019_0863,3,WCR2019_0223,WCR2019_0161,within-group subordinate,within-group subordinate,73,37,36,26,40,63,77,1,99999,488,808,469,0.396270396270396,0,0,NA,NA,none,hothiphop.parents,hot.parents
2019,1,WCR2019_0864,1,WCR2019_0223,WCR2019_0327,within-group subordinate,within-group subordinate,59,26,33,28,20,54,46,1,99999,488,826,473,0.424737456242707,0,0,NA,NA,none,hothiphop.parents,hot.parents
2019,1,WCR2019_0864,2,WCR2019_0223,WCR2019_0061,within-group subordinate,within-group subordinate,63,24,39,28,35,52,59,1,99999,488,759,425,0.424737456242707,0,0,NA,NA,none,hothiphop.parents,hot.parents
2019,1,WCR2019_0864,3,WCR2019_0223,WCR2019_0087,within-group subordinate,within-group subordinate,65,25,40,28,46,53,71,1,99999,488,624,355,0.424737456242707,0,0,NA,NA,none,hothiphop.parents,hot.parents
2019,1,WCR2019_0865,1,WCR2019_0223,WCR2019_0061,within-group subordinate,within-group subordinate,66,30,36,29,39,59,69,1,99999,487,758,424,0.426401869158879,0,0,NA,NA,none,hothiphop.parents,hot.parents
2019,1,WCR2019_0865,2,WCR2019_0440,WCR2019_0122,within-group subordinate,within-group subordinate,67,32,35,23,24,55,56,1,99999,567,844,561,0.426401869158879,0,0,NA,NA,none,hothiphop.parents,hot.parents
2019,1,WCR2019_0865,3,WCR2019_0223,WCR2019_0327,within-group subordinate,within-group subordinate,70,33,37,29,18,62,51,1,99999,487,825,472,0.426401869158879,0,0,NA,NA,none,hothiphop.parents,hot.parents
2019,1,WCR2019_0866,1,WCR2019_0223,WCR2019_0359,within-group subordinate,within-group subordinate,36,21,15,14,4,35,25,1,99999,485,811,461,0.379835873388042,0,0,NA,NA,none,hothiphop.parents,hot.parents
2019,1,WCR2019_0866,2,WCR2019_0223,WCR2019_0075,within-group subordinate,within-group subordinate,37,20,17,14,23,34,43,1,99999,485,743,415,0.379835873388042,0,0,NA,NA,none,hothiphop.parents,hot.parents
2019,1,WCR2019_0866,3,WCR2019_0223,WCR2019_0327,within-group subordinate,within-group subordinate,38,20,18,14,13,34,33,1,99999,485,822,470,0.379835873388042,0,0,NA,NA,none,hothiphop.parents,hot.parents
2019,1,WCR2019_0868,1,WCR2019_0223,WCR2019_0327,within-group subordinate,within-group subordinate,50,24,26,18,22,42,46,1,99999,486,826,471,0.429404900816803,0,0,NA,NA,none,hothiphop.parents,hot.parents
2019,1,WCR2019_0868,2,WCR2019_0223,WCR2019_0161,within-group subordinate,within-group subordinate,53,33,20,18,15,51,48,1,99999,486,807,467,0.429404900816803,0,0,NA,NA,none,hothiphop.parents,hot.parents
2019,1,WCR2019_0868,3,WCR2019_0223,WCR2019_0122,within-group subordinate,within-group subordinate,60,34,26,18,25,52,59,1,99999,486,845,479,0.429404900816803,0,0,NA,NA,none,hothiphop.parents,hot.parents
2019,1,WCR2019_0869,1,WCR2019_0223,WCR2019_0087,within-group subordinate,within-group subordinate,56,20,36,30,40,50,60,1,99999,487,626,355,0.348484848484849,0,0,NA,NA,none,hothiphop.parents,hot.parents
2019,1,WCR2019_0869,2,WCR2019_0440,WCR2019_0087,within-group subordinate,within-group subordinate,64,18,46,41,40,59,58,1,99999,567,626,413,0.348484848484849,0,0,NA,NA,none,hothiphop.parents,hot.parents
2019,1,WCR2019_0869,3,WCR2019_0223,WCR2019_0327,within-group subordinate,within-group subordinate,65,26,39,30,31,56,57,1,99999,487,827,472,0.348484848484849,0,0,NA,NA,none,hothiphop.parents,hot.parents
2019,1,WCR2019_0870,1,WCR2019_0223,WCR2019_0461,within-group subordinate,within-group subordinate,53,26,27,27,2,53,28,1,99999,488,854,487,0.372960372960373,0,0,NA,NA,none,hothiphop.parents,hot.parents
2019,1,WCR2019_0870,2,WCR2019_0223,WCR2019_0087,within-group subordinate,within-group subordinate,54,19,35,27,41,46,60,1,99999,488,625,355,0.372960372960373,0,0,NA,NA,none,hothiphop.parents,hot.parents
2019,1,WCR2019_0870,3,WCR2019_0223,WCR2019_0075,within-group subordinate,within-group subordinate,64,27,37,27,48,54,75,1,99999,488,748,418,0.372960372960373,0,0,NA,NA,none,hothiphop.parents,hot.parents
2019,1,WCR2019_0871,1,WCR2019_0223,WCR2019_0087,within-group subordinate,within-group subordinate,63,25,38,27,42,52,67,1,99999,489,624,356,0.352392065344224,0,0,NA,NA,none,hothiphop.parents,hot.parents
2019,1,WCR2019_0871,2,WCR2019_0223,WCR2019_0061,within-group subordinate,within-group subordinate,64,26,38,27,44,53,70,1,99999,489,759,426,0.352392065344224,0,0,NA,NA,none,hothiphop.parents,hot.parents
2019,1,WCR2019_0871,3,WCR2019_0223,WCR2019_0327,within-group subordinate,within-group subordinate,66,33,33,27,27,60,60,1,99999,489,826,474,0.352392065344224,0,0,NA,NA,none,hothiphop.parents,hot.parents
2019,1,WCR2019_0872,1,WCR2019_0223,WCR2019_0327,within-group subordinate,within-group subordinate,51,27,24,23,18,50,45,1,99999,486,824,471,0.465497076023392,0,0,NA,NA,none,hothiphop.parents,hot.parents
2019,1,WCR2019_0872,2,WCR2019_0223,WCR2019_0122,within-group subordinate,within-group subordinate,60,31,29,23,25,54,56,1,99999,486,843,479,0.465497076023392,0,0,NA,NA,none,hothiphop.parents,hot.parents
2019,1,WCR2019_0872,3,WCR2019_0223,WCR2019_0087,within-group subordinate,within-group subordinate,60,22,38,23,41,45,63,1,99999,486,623,354,0.465497076023392,0,0,NA,NA,none,hothiphop.parents,hot.parents
2019,1,WCR2019_0873,1,WCR2019_0223,WCR2019_0088,within-group subordinate,within-group subordinate,28,19,9,11,0,30,19,1,99999,485,642,378,0.454332552693208,0,0,NA,NA,none,hothiphop.parents,hot.parents
2019,1,WCR2019_0873,2,WCR2019_0223,WCR2019_0327,within-group subordinate,within-group subordinate,32,19,13,11,3,30,22,1,99999,485,823,470,0.454332552693208,0,0,NA,NA,none,hothiphop.parents,hot.parents
2019,1,WCR2019_0873,3,WCR2019_0223,WCR2019_0407,within-group subordinate,within-group subordinate,35,22,13,11,4,33,26,1,99999,485,848,481,0.454332552693208,0,0,NA,NA,none,hothiphop.parents,hot.parents
2019,1,WCR2019_0874,1,WCR2019_0064,WCR2019_0451,within-group subordinate,within-group subordinate,3,1,2,2,3,3,4,1,99999,630,841,627,0.0568720379146919,0,0,NA,NA,none,hothiphop.parents,hot.parents
2019,1,WCR2019_0874,2,WCR2019_0252,WCR2019_0088,within-group subordinate,within-group subordinate,3,0,3,1,3,1,3,1,99999,842,637,635,0.0568720379146919,0,0,NA,NA,none,hothiphop.parents,hot.parents
2019,1,WCR2019_0874,3,WCR2019_0252,WCR2019_0122,within-group subordinate,within-group subordinate,3,0,3,1,2,1,2,1,99999,842,832,830,0.0568720379146919,0,0,NA,NA,none,hothiphop.parents,hot.parents
2019,1,WCR2019_0876,1,WCR2019_0324,WCR2019_0161,within-group subordinate,within-group subordinate,33,25,8,2,7,27,32,1,99999,857,809,807,0.257275902211874,0,0,NA,NA,none,hothiphop.parents,hot.parents
2019,1,WCR2019_0876,2,WCR2019_0361,WCR2019_0161,within-group subordinate,within-group subordinate,33,23,10,5,7,28,30,1,99999,799,809,751,0.257275902211874,0,0,NA,NA,none,hothiphop.parents,hot.parents
2019,1,WCR2019_0876,3,WCR2019_0474,WCR2019_0327,within-group subordinate,within-group subordinate,34,27,7,3,6,30,33,1,99999,737,828,712,0.257275902211874,0,0,NA,NA,none,hothiphop.parents,hot.parents
2019,1,WCR2019_0878,1,WCR2019_0223,WCR2019_0088,within-group subordinate,within-group subordinate,39,17,22,14,27,31,44,1,99999,487,643,379,0.429404900816803,0,0,NA,NA,none,hothiphop.parents,hot.parents
2019,1,WCR2019_0878,2,WCR2019_0223,WCR2019_0327,within-group subordinate,within-group subordinate,44,28,16,14,11,42,39,1,99999,487,827,473,0.429404900816803,0,0,NA,NA,none,hothiphop.parents,hot.parents
2019,1,WCR2019_0878,3,WCR2019_0223,WCR2019_0161,within-group subordinate,within-group subordinate,49,29,20,14,19,43,48,1,99999,487,807,468,0.429404900816803,0,0,NA,NA,none,hothiphop.parents,hot.parents
2019,1,WCR2019_0880,1,WCR2019_0337,WCR2019_0405,within-group subordinate,within-group subordinate,4,0,4,2,2,2,2,1,99999,855,808,805,0.474358974358974,0,0,NA,NA,none,hothiphop.parents,hot.parents
2019,1,WCR2019_0880,2,WCR2019_0337,WCR2019_0265,within-group subordinate,within-group subordinate,10,8,2,2,0,10,8,1,99999,855,850,847,0.474358974358974,0,0,NA,NA,none,hothiphop.parents,hot.parents
2019,1,WCR2019_0880,3,WCR2019_0337,WCR2019_0088,within-group subordinate,within-group subordinate,10,7,3,2,2,9,9,1,99999,855,644,641,0.474358974358974,0,0,NA,NA,none,hothiphop.parents,hot.parents
2019,1,WCR2019_0881,1,WCR2019_0223,WCR2019_0087,within-group subordinate,within-group subordinate,56,22,34,27,36,49,58,1,99999,487,625,355,0.35705950991832,0,0,NA,NA,none,hothiphop.parents,hot.parents
2019,1,WCR2019_0881,2,WCR2019_0532,WCR2019_0327,within-group subordinate,within-group subordinate,60,38,22,2,22,40,60,1,99999,846,826,815,0.35705950991832,0,0,NA,NA,none,hothiphop.parents,hot.parents
2019,1,WCR2019_0881,3,WCR2019_0223,WCR2019_0327,within-group subordinate,within-group subordinate,60,30,30,27,22,57,52,1,99999,487,826,472,0.35705950991832,0,0,NA,NA,none,hothiphop.parents,hot.parents
2019,1,WCR2019_0882,1,WCR2019_0337,WCR2019_0405,within-group subordinate,within-group subordinate,5,0,5,1,4,1,4,1,99999,854,807,804,0.446907817969662,0,0,NA,NA,none,hothiphop.parents,hot.parents
2019,1,WCR2019_0882,2,WCR2019_0337,WCR2019_0047,within-group subordinate,within-group subordinate,11,9,2,1,1,10,10,1,99999,854,856,853,0.446907817969662,0,0,NA,NA,none,hothiphop.parents,hot.parents
2019,1,WCR2019_0882,3,WCR2019_0337,WCR2019_0265,within-group subordinate,within-group subordinate,11,8,3,1,2,9,10,1,99999,854,849,846,0.446907817969662,0,0,NA,NA,none,hothiphop.parents,hot.parents
2019,1,WCR2019_0883,1,WCR2019_0223,WCR2019_0327,within-group subordinate,within-group subordinate,53,31,22,13,14,44,45,1,99999,487,824,472,0.416374269005848,0,0,NA,NA,none,hothiphop.parents,hot.parents
2019,1,WCR2019_0883,2,WCR2019_0223,WCR2019_0087,within-group subordinate,within-group subordinate,54,21,33,13,47,34,68,1,99999,487,624,355,0.416374269005848,0,0,NA,NA,none,hothiphop.parents,hot.parents
2019,1,WCR2019_0883,3,WCR2019_0223,WCR2019_0122,within-group subordinate,within-group subordinate,55,34,21,13,15,47,49,1,99999,487,844,480,0.416374269005848,0,0,NA,NA,none,hothiphop.parents,hot.parents
2019,1,WCR2019_0885,1,WCR2019_0440,WCR2019_0122,within-group subordinate,within-group subordinate,56,24,32,21,21,45,45,1,99999,561,839,555,0.396004700352526,0,0,NA,NA,none,hothiphop.parents,hot.parents
2019,1,WCR2019_0885,2,WCR2019_0440,WCR2019_0327,within-group subordinate,within-group subordinate,57,30,27,21,21,51,51,1,99999,561,821,542,0.396004700352526,0,0,NA,NA,none,hothiphop.parents,hot.parents
2019,1,WCR2019_0885,3,WCR2019_0223,WCR2019_0327,within-group subordinate,within-group subordinate,61,27,34,29,21,56,48,1,99999,483,821,469,0.396004700352526,0,0,NA,NA,none,hothiphop.parents,hot.parents
2019,1,WCR2019_0931,1,WCR2019_0223,WCR2019_0087,within-group subordinate,within-group subordinate,57,23,34,26,39,49,62,1,99999,483,622,351,0.362352941176471,0,0,NA,NA,none,hothiphop.parents,hot.parents
2019,1,WCR2019_0931,2,WCR2019_0223,WCR2019_0327,within-group subordinate,within-group subordinate,59,30,29,26,21,56,51,1,99999,483,819,468,0.362352941176471,0,0,NA,NA,none,hothiphop.parents,hot.parents
2019,1,WCR2019_0931,3,WCR2019_0440,WCR2019_0087,within-group subordinate,within-group subordinate,63,26,37,22,39,48,65,1,99999,561,622,409,0.362352941176471,0,0,NA,NA,none,hothiphop.parents,hot.parents
2019,1,WCR2019_0932,1,WCR2019_0482,WCR2019_0475,within-group subordinate,within-group subordinate,42,23,19,15,4,38,27,1,99999,822,854,821,0.411695906432749,0,0,NA,NA,none,hothiphop.parents,hot.parents
2019,1,WCR2019_0932,2,WCR2019_0223,WCR2019_0327,within-group subordinate,within-group subordinate,56,26,30,25,18,51,44,1,99999,485,824,470,0.411695906432749,0,0,NA,NA,none,hothiphop.parents,hot.parents
2019,1,WCR2019_0932,3,WCR2019_0223,WCR2019_0075,within-group subordinate,within-group subordinate,58,30,28,25,24,55,54,1,99999,485,746,416,0.411695906432749,0,0,NA,NA,none,hothiphop.parents,hot.parents
2019,1,WCR2019_0933,1,WCR2019_0223,WCR2019_0061,within-group subordinate,within-group subordinate,53,25,28,20,29,45,54,1,99999,486,759,424,0.435747663551402,0,0,NA,NA,none,hothiphop.parents,hot.parents
2019,1,WCR2019_0933,2,WCR2019_0223,WCR2019_0327,within-group subordinate,within-group subordinate,54,28,26,20,21,48,49,1,99999,486,825,471,0.435747663551402,0,0,NA,NA,none,hothiphop.parents,hot.parents
2019,1,WCR2019_0933,3,WCR2019_0223,WCR2019_0075,within-group subordinate,within-group subordinate,56,35,21,20,27,55,62,1,99999,486,747,417,0.435747663551402,0,0,NA,NA,none,hothiphop.parents,hot.parents
2019,1,WCR2019_0934,1,WCR2019_0223,WCR2019_0087,within-group subordinate,within-group subordinate,58,31,27,20,29,51,60,1,99999,469,605,342,0.473939393939394,0,0,NA,NA,none,hothiphop.parents,hot.parents
2019,1,WCR2019_0934,2,WCR2019_0191,WCR2019_0087,within-group subordinate,within-group subordinate,58,29,29,22,29,51,58,1,99999,626,605,448,0.473939393939394,0,0,NA,NA,none,hothiphop.parents,hot.parents
2019,1,WCR2019_0934,3,WCR2019_0440,WCR2019_0087,within-group subordinate,within-group subordinate,60,30,30,18,29,48,59,1,99999,547,605,400,0.473939393939394,0,0,NA,NA,none,hothiphop.parents,hot.parents
2019,1,WCR2019_0935,1,WCR2019_0223,WCR2019_0087,within-group subordinate,within-group subordinate,61,27,34,26,44,53,71,1,99999,487,625,354,0.364801864801865,0,0,NA,NA,none,hothiphop.parents,hot.parents
2019,1,WCR2019_0935,2,WCR2019_0223,WCR2019_0061,within-group subordinate,within-group subordinate,63,27,36,26,40,53,67,1,99999,487,760,424,0.364801864801865,0,0,NA,NA,none,hothiphop.parents,hot.parents
2019,1,WCR2019_0935,3,WCR2019_0223,WCR2019_0161,within-group subordinate,within-group subordinate,71,34,37,26,38,60,72,1,99999,487,808,468,0.364801864801865,0,0,NA,NA,none,hothiphop.parents,hot.parents
2019,1,WCR2019_0936,1,WCR2019_0420,WCR2019_0405,within-group subordinate,within-group subordinate,1,0,1,0,1,0,1,1,99999,848,800,799,0.0530035335689046,0,0,NA,NA,none,hothiphop.parents,hot.parents
2019,1,WCR2019_0936,2,WCR2019_0474,WCR2019_0405,within-group subordinate,within-group subordinate,3,1,2,2,1,3,2,1,99999,729,800,686,0.0530035335689046,0,0,NA,NA,none,hothiphop.parents,hot.parents
2019,1,WCR2019_0936,3,WCR2019_0420,WCR2019_0518,within-group subordinate,within-group subordinate,4,1,3,0,3,1,4,1,99999,848,838,837,0.0530035335689046,0,0,NA,NA,none,hothiphop.parents,hot.parents
2019,1,WCR2019_0937,1,WCR2019_0409,WCR2019_0039,within-group subordinate,within-group subordinate,7,4,3,2,3,6,7,1,99999,851,834,829,0.0490654205607477,0,0,NA,NA,none,hothiphop.parents,hot.parents
2019,1,WCR2019_0937,2,WCR2019_0064,WCR2019_0039,within-group subordinate,within-group subordinate,7,3,4,3,3,6,6,1,99999,639,834,630,0.0490654205607477,0,0,NA,NA,none,hothiphop.parents,hot.parents
2019,1,WCR2019_0937,3,WCR2019_0474,WCR2019_0039,within-group subordinate,within-group subordinate,7,2,5,2,3,4,5,1,99999,734,834,715,0.0490654205607477,0,0,NA,NA,none,hothiphop.parents,hot.parents
2019,1,WCR2019_0938,1,WCR2019_0479,WCR2019_0088,within-group subordinate,within-group subordinate,16,11,5,3,2,14,13,1,99999,844,638,635,0.189858490566038,0,0,NA,NA,none,hothiphop.parents,hot.parents
2019,1,WCR2019_0938,2,WCR2019_0011,WCR2019_0088,within-group subordinate,within-group subordinate,20,17,3,4,2,21,19,1,99999,847,638,637,0.189858490566038,0,0,NA,NA,none,hothiphop.parents,hot.parents
2019,1,WCR2019_0938,3,WCR2019_0263,WCR2019_0088,within-group subordinate,within-group subordinate,20,14,6,7,2,21,16,1,99999,840,638,633,0.189858490566038,0,0,NA,NA,none,hothiphop.parents,hot.parents
2019,1,WCR2019_0939,1,WCR2019_0223,WCR2019_0327,within-group subordinate,within-group subordinate,68,29,39,29,31,58,60,1,99999,486,824,471,0.353216374269006,0,0,NA,NA,none,hothiphop.parents,hot.parents
2019,1,WCR2019_0939,2,WCR2019_0440,WCR2019_0087,within-group subordinate,within-group subordinate,69,22,47,31,49,53,71,1,99999,566,625,412,0.353216374269006,0,0,NA,NA,none,hothiphop.parents,hot.parents
2019,1,WCR2019_0939,3,WCR2019_0223,WCR2019_0087,within-group subordinate,within-group subordinate,70,23,47,29,49,52,72,1,99999,486,625,354,0.353216374269006,0,0,NA,NA,none,hothiphop.parents,hot.parents
2019,1,WCR2019_0940,1,WCR2019_0223,WCR2019_0061,within-group subordinate,within-group subordinate,60,33,27,16,27,49,60,1,99999,483,755,420,0.442488262910798,0,0,NA,NA,none,hothiphop.parents,hot.parents
2019,1,WCR2019_0940,2,WCR2019_0440,WCR2019_0122,within-group subordinate,within-group subordinate,61,27,34,26,24,53,51,1,99999,563,840,557,0.442488262910798,0,0,NA,NA,none,hothiphop.parents,hot.parents
2019,1,WCR2019_0940,3,WCR2019_0223,WCR2019_0087,within-group subordinate,within-group subordinate,61,25,36,16,47,41,72,1,99999,483,623,353,0.442488262910798,0,0,NA,NA,none,hothiphop.parents,hot.parents
2019,1,WCR2019_0941,1,WCR2019_0223,WCR2019_0047,within-group subordinate,within-group subordinate,54,30,24,21,4,51,34,1,99999,488,857,487,0.398601398601399,0,0,NA,NA,none,hothiphop.parents,hot.parents
2019,1,WCR2019_0941,2,WCR2019_0223,WCR2019_0327,within-group subordinate,within-group subordinate,56,26,30,21,21,47,47,1,99999,488,827,473,0.398601398601399,0,0,NA,NA,none,hothiphop.parents,hot.parents
2019,1,WCR2019_0941,3,WCR2019_0223,WCR2019_0075,within-group subordinate,within-group subordinate,58,32,26,21,38,53,70,1,99999,488,748,418,0.398601398601399,0,0,NA,NA,none,hothiphop.parents,hot.parents
2019,1,WCR2019_0942,1,WCR2019_0223,WCR2019_0327,within-group subordinate,within-group subordinate,66,35,31,29,20,64,55,1,99999,486,823,471,0.432084309133489,0,0,NA,NA,none,hothiphop.parents,hot.parents
2019,1,WCR2019_0942,2,WCR2019_0223,WCR2019_0061,within-group subordinate,within-group subordinate,66,30,36,29,37,59,67,1,99999,486,759,424,0.432084309133489,0,0,NA,NA,none,hothiphop.parents,hot.parents
2019,1,WCR2019_0942,3,WCR2019_0440,WCR2019_0122,within-group subordinate,within-group subordinate,68,33,35,21,28,54,61,1,99999,565,842,559,0.432084309133489,0,0,NA,NA,none,hothiphop.parents,hot.parents
2019,1,WCR2019_0944,1,WCR2019_0252,WCR2019_0461,within-group subordinate,within-group subordinate,29,17,12,9,3,26,20,1,99999,853,852,849,0.421728971962617,0,0,NA,NA,none,hothiphop.parents,hot.parents
2019,1,WCR2019_0944,2,WCR2019_0223,WCR2019_0088,within-group subordinate,within-group subordinate,31,17,14,17,14,34,31,1,99999,487,644,380,0.421728971962617,0,0,NA,NA,none,hothiphop.parents,hot.parents
2019,1,WCR2019_0944,3,WCR2019_0467,WCR2019_0461,within-group subordinate,within-group subordinate,32,18,14,12,3,30,21,1,99999,856,852,852,0.421728971962617,0,0,NA,NA,none,hothiphop.parents,hot.parents
2019,1,WCR2019_0945,1,WCR2019_0223,WCR2019_0445,within-group subordinate,within-group subordinate,56,25,31,30,1,55,26,1,99999,480,837,479,0.377962085308057,0,0,NA,NA,none,hothiphop.parents,hot.parents
2019,1,WCR2019_0945,2,WCR2019_0191,WCR2019_0445,within-group subordinate,within-group subordinate,62,31,31,30,1,61,32,1,99999,638,837,633,0.377962085308057,0,0,NA,NA,none,hothiphop.parents,hot.parents
2019,1,WCR2019_0945,3,WCR2019_0440,WCR2019_0122,within-group subordinate,within-group subordinate,62,25,37,23,29,48,54,1,99999,558,833,553,0.377962085308057,0,0,NA,NA,none,hothiphop.parents,hot.parents
2019,1,WCR2019_0946,1,WCR2019_0223,WCR2019_0088,within-group subordinate,within-group subordinate,58,24,34,30,27,54,51,1,99999,487,644,379,0.414235705950992,0,0,NA,NA,none,hothiphop.parents,hot.parents
2019,1,WCR2019_0946,2,WCR2019_0223,WCR2019_0327,within-group subordinate,within-group subordinate,64,33,31,30,16,63,49,1,99999,487,826,472,0.414235705950992,0,0,NA,NA,none,hothiphop.parents,hot.parents
2019,1,WCR2019_0946,3,WCR2019_0223,WCR2019_0061,within-group subordinate,within-group subordinate,64,30,34,30,28,60,58,1,99999,487,759,424,0.414235705950992,0,0,NA,NA,none,hothiphop.parents,hot.parents
2019,1,WCR2019_0947,1,WCR2019_0223,WCR2019_0327,within-group subordinate,within-group subordinate,51,34,17,15,11,49,45,1,99999,487,825,472,0.436915887850467,0,0,NA,NA,none,hothiphop.parents,hot.parents
2019,1,WCR2019_0947,2,WCR2019_0223,WCR2019_0088,within-group subordinate,within-group subordinate,53,31,22,15,19,46,50,1,99999,487,643,380,0.436915887850467,0,0,NA,NA,none,hothiphop.parents,hot.parents
2019,1,WCR2019_0947,3,WCR2019_0440,WCR2019_0122,within-group subordinate,within-group subordinate,53,27,26,21,11,48,38,1,99999,567,844,561,0.436915887850467,0,0,NA,NA,none,hothiphop.parents,hot.parents
2019,1,WCR2019_0948,1,WCR2019_0223,WCR2019_0088,within-group subordinate,within-group subordinate,47,21,26,17,36,38,57,1,99999,487,643,379,0.416374269005848,0,0,NA,NA,none,hothiphop.parents,hot.parents
2019,1,WCR2019_0948,2,WCR2019_0482,WCR2019_0475,within-group subordinate,within-group subordinate,49,26,23,21,2,47,28,1,99999,822,854,821,0.416374269005848,0,0,NA,NA,none,hothiphop.parents,hot.parents
2019,1,WCR2019_0948,3,WCR2019_0440,WCR2019_0475,within-group subordinate,within-group subordinate,50,33,17,16,2,49,35,1,99999,566,854,566,0.416374269005848,0,0,NA,NA,none,hothiphop.parents,hot.parents
2019,1,WCR2019_0949,1,WCR2019_0223,WCR2019_0087,within-group subordinate,within-group subordinate,51,17,34,24,42,41,59,1,99999,484,623,353,0.375878220140515,0,0,NA,NA,none,hothiphop.parents,hot.parents
2019,1,WCR2019_0949,2,WCR2019_0440,WCR2019_0087,within-group subordinate,within-group subordinate,65,22,43,28,42,50,64,1,99999,565,623,412,0.375878220140515,0,0,NA,NA,none,hothiphop.parents,hot.parents
2019,1,WCR2019_0949,3,WCR2019_0223,WCR2019_0327,within-group subordinate,within-group subordinate,69,39,30,24,17,63,56,1,99999,484,823,469,0.375878220140515,0,0,NA,NA,none,hothiphop.parents,hot.parents
2019,1,WCR2019_0950,1,WCR2019_0223,WCR2019_0088,within-group subordinate,within-group subordinate,41,10,31,35,12,45,22,1,99999,488,644,381,0.277712952158693,0,0,NA,NA,none,hothiphop.parents,hot.parents
2019,1,WCR2019_0950,2,WCR2019_0403,WCR2019_0122,within-group subordinate,within-group subordinate,45,30,15,12,9,42,39,1,99999,821,845,809,0.277712952158693,0,0,NA,NA,none,hothiphop.parents,hot.parents
2019,1,WCR2019_0950,3,WCR2019_0192,WCR2019_0088,within-group subordinate,within-group subordinate,45,28,17,14,12,42,40,1,99999,856,644,643,0.277712952158693,0,0,NA,NA,none,hothiphop.parents,hot.parents
2019,1,WCR2019_0953,1,WCR2019_0223,WCR2019_0150,within-group subordinate,within-group subordinate,50,21,29,29,0,50,21,1,99999,486,852,486,0.389671361502347,0,0,NA,NA,none,hothiphop.parents,hot.parents
2019,1,WCR2019_0953,2,WCR2019_0440,WCR2019_0150,within-group subordinate,within-group subordinate,51,27,24,24,0,51,27,1,99999,563,852,563,0.389671361502347,0,0,NA,NA,none,hothiphop.parents,hot.parents
2019,1,WCR2019_0953,3,WCR2019_0191,WCR2019_0150,within-group subordinate,within-group subordinate,59,29,30,30,0,59,29,1,99999,643,852,643,0.389671361502347,0,0,NA,NA,none,hothiphop.parents,hot.parents
2019,1,WCR2019_0954,1,WCR2019_0223,WCR2019_0088,within-group subordinate,within-group subordinate,43,18,25,28,2,46,20,1,99999,487,644,380,0.379672897196262,0,0,NA,NA,none,hothiphop.parents,hot.parents
2019,1,WCR2019_0954,2,WCR2019_0441,WCR2019_0327,within-group subordinate,within-group subordinate,44,35,9,4,5,39,40,1,99999,852,825,821,0.379672897196262,0,0,NA,NA,none,hothiphop.parents,hot.parents
2019,1,WCR2019_0954,3,WCR2019_0223,WCR2019_0327,within-group subordinate,within-group subordinate,46,16,30,28,5,44,21,1,99999,487,825,472,0.379672897196262,0,0,NA,NA,none,hothiphop.parents,hot.parents
2019,1,WCR2019_0955,1,WCR2019_0223,WCR2019_0075,within-group subordinate,within-group subordinate,49,30,19,18,23,48,53,1,99999,485,745,415,0.410526315789474,0,0,NA,NA,none,hothiphop.parents,hot.parents
2019,1,WCR2019_0955,2,WCR2019_0223,WCR2019_0161,within-group subordinate,within-group subordinate,55,34,21,18,17,52,51,1,99999,485,805,466,0.410526315789474,0,0,NA,NA,none,hothiphop.parents,hot.parents
2019,1,WCR2019_0955,3,WCR2019_0223,WCR2019_0088,within-group subordinate,within-group subordinate,55,25,30,18,31,43,56,1,99999,485,642,378,0.410526315789474,0,0,NA,NA,none,hothiphop.parents,hot.parents
2019,1,WCR2019_0956,1,WCR2019_0223,WCR2019_0475,within-group subordinate,within-group subordinate,49,30,19,17,3,47,33,1,99999,463,804,462,0.418633540372671,0,0,NA,NA,none,hothiphop.parents,hot.parents
2019,1,WCR2019_0956,2,WCR2019_0223,WCR2019_0327,within-group subordinate,within-group subordinate,51,27,24,17,15,44,42,1,99999,463,775,448,0.418633540372671,0,0,NA,NA,none,hothiphop.parents,hot.parents
2019,1,WCR2019_0956,3,WCR2019_0223,WCR2019_0417,within-group subordinate,within-group subordinate,54,30,24,17,18,47,48,1,99999,463,802,461,0.418633540372671,0,0,NA,NA,none,hothiphop.parents,hot.parents
2019,1,WCR2019_0957,1,WCR2019_0223,WCR2019_0088,within-group subordinate,within-group subordinate,48,23,25,27,13,50,36,1,99999,485,641,378,0.389929742388759,0,0,NA,NA,none,hothiphop.parents,hot.parents
2019,1,WCR2019_0957,2,WCR2019_0223,WCR2019_0327,within-group subordinate,within-group subordinate,49,21,28,27,18,48,39,1,99999,485,824,470,0.389929742388759,0,0,NA,NA,none,hothiphop.parents,hot.parents
2019,1,WCR2019_0957,3,WCR2019_0223,WCR2019_0047,within-group subordinate,within-group subordinate,51,22,29,27,2,49,24,1,99999,485,853,484,0.389929742388759,0,0,NA,NA,none,hothiphop.parents,hot.parents
2019,1,WCR2019_0959,1,WCR2019_0223,WCR2019_0088,within-group subordinate,within-group subordinate,47,25,22,23,21,48,46,1,99999,487,645,380,0.418414918414918,0,0,NA,NA,none,hothiphop.parents,hot.parents
2019,1,WCR2019_0959,2,WCR2019_0223,WCR2019_0161,within-group subordinate,within-group subordinate,57,30,27,23,19,53,49,1,99999,487,808,468,0.418414918414918,0,0,NA,NA,none,hothiphop.parents,hot.parents
2019,1,WCR2019_0959,3,WCR2019_0223,WCR2019_0061,within-group subordinate,within-group subordinate,57,28,29,23,34,51,62,1,99999,487,761,425,0.418414918414918,0,0,NA,NA,none,hothiphop.parents,hot.parents
2019,1,WCR2019_0961,1,WCR2019_0223,WCR2019_0087,within-group subordinate,within-group subordinate,64,19,45,28,47,47,66,1,99999,485,626,355,0.371194379391101,0,0,NA,NA,none,hothiphop.parents,hot.parents
2019,1,WCR2019_0961,2,WCR2019_0223,WCR2019_0061,within-group subordinate,within-group subordinate,69,24,45,28,51,52,75,1,99999,485,757,423,0.371194379391101,0,0,NA,NA,none,hothiphop.parents,hot.parents
2019,1,WCR2019_0961,3,WCR2019_0223,WCR2019_0073,within-group subordinate,within-group subordinate,70,20,50,28,59,48,79,1,99999,485,785,436,0.371194379391101,0,0,NA,NA,none,hothiphop.parents,hot.parents
2019,1,WCR2019_0963,1,WCR2019_0223,WCR2019_0087,within-group subordinate,within-group subordinate,58,16,42,28,40,44,56,1,99999,488,627,356,0.366705471478463,0,0,NA,NA,none,hothiphop.parents,hot.parents
2019,1,WCR2019_0963,2,WCR2019_0223,WCR2019_0122,within-group subordinate,within-group subordinate,70,30,40,28,37,58,67,1,99999,488,847,481,0.366705471478463,0,0,NA,NA,none,hothiphop.parents,hot.parents
2019,1,WCR2019_0963,3,WCR2019_0223,WCR2019_0494,within-group subordinate,within-group subordinate,70,27,43,28,58,55,85,1,99999,488,854,486,0.366705471478463,0,0,NA,NA,none,hothiphop.parents,hot.parents
2019,1,WCR2019_0964,1,WCR2019_0223,WCR2019_0258,within-group subordinate,within-group subordinate,50,35,15,16,2,51,37,1,99999,483,836,479,0.475294117647059,0,0,NA,NA,none,hothiphop.parents,hot.parents
2019,1,WCR2019_0964,2,WCR2019_0223,WCR2019_0061,within-group subordinate,within-group subordinate,54,28,26,16,30,44,58,1,99999,483,754,421,0.475294117647059,0,0,NA,NA,none,hothiphop.parents,hot.parents
2019,1,WCR2019_0964,3,WCR2019_0223,WCR2019_0327,within-group subordinate,within-group subordinate,56,33,23,16,19,49,52,1,99999,483,819,468,0.475294117647059,0,0,NA,NA,none,hothiphop.parents,hot.parents
2019,1,WCR2019_0965,1,WCR2019_0223,WCR2019_0061,within-group subordinate,within-group subordinate,57,23,34,29,42,52,65,1,99999,486,760,424,0.371061843640607,0,0,NA,NA,none,hothiphop.parents,hot.parents
2019,1,WCR2019_0965,2,WCR2019_0223,WCR2019_0087,within-group subordinate,within-group subordinate,62,18,44,29,60,47,78,1,99999,486,624,353,0.371061843640607,0,0,NA,NA,none,hothiphop.parents,hot.parents
2019,1,WCR2019_0965,3,WCR2019_0223,WCR2019_0327,within-group subordinate,within-group subordinate,65,30,35,29,23,59,53,1,99999,486,826,471,0.371061843640607,0,0,NA,NA,none,hothiphop.parents,hot.parents
2019,1,WCR2019_0966,1,WCR2019_0440,WCR2019_0327,within-group subordinate,within-group subordinate,70,32,38,33,27,65,59,1,99999,567,825,547,0.377336448598131,0,0,NA,NA,none,hothiphop.parents,hot.parents
2019,1,WCR2019_0966,2,WCR2019_0223,WCR2019_0327,within-group subordinate,within-group subordinate,70,31,39,29,27,60,58,1,99999,487,825,472,0.377336448598131,0,0,NA,NA,none,hothiphop.parents,hot.parents
2019,1,WCR2019_0966,3,WCR2019_0223,WCR2019_0061,within-group subordinate,within-group subordinate,71,33,38,29,42,62,75,1,99999,487,759,425,0.377336448598131,0,0,NA,NA,none,hothiphop.parents,hot.parents
2019,1,WCR2019_0967,1,WCR2019_0223,WCR2019_0088,within-group subordinate,within-group subordinate,32,18,14,17,1,35,19,1,99999,486,643,378,0.393232205367561,0,0,NA,NA,none,hothiphop.parents,hot.parents
2019,1,WCR2019_0967,2,WCR2019_0223,WCR2019_0075,within-group subordinate,within-group subordinate,40,23,17,17,5,40,28,1,99999,486,747,416,0.393232205367561,0,0,NA,NA,none,hothiphop.parents,hot.parents
2019,1,WCR2019_0967,3,WCR2019_0223,WCR2019_0161,within-group subordinate,within-group subordinate,41,25,16,17,3,42,28,1,99999,486,807,467,0.393232205367561,0,0,NA,NA,none,hothiphop.parents,hot.parents
2019,1,WCR2019_0969,1,WCR2019_0496,WCR2019_0161,within-group subordinate,within-group subordinate,21,15,6,3,4,18,19,1,99999,833,791,785,0.23452380952381,0,0,NA,NA,none,hothiphop.parents,hot.parents
2019,1,WCR2019_0969,2,WCR2019_0403,WCR2019_0161,within-group subordinate,within-group subordinate,28,21,7,3,4,24,25,1,99999,804,791,755,0.23452380952381,0,0,NA,NA,none,hothiphop.parents,hot.parents
2019,1,WCR2019_0969,3,WCR2019_0479,WCR2019_0161,within-group subordinate,within-group subordinate,29,25,4,0,4,25,29,1,99999,836,791,789,0.23452380952381,0,0,NA,NA,none,hothiphop.parents,hot.parents
2019,1,WCR2019_0970,1,WCR2019_0223,WCR2019_0088,within-group subordinate,within-group subordinate,48,24,24,19,23,43,47,1,99999,488,646,381,0.434225844004657,0,0,NA,NA,none,hothiphop.parents,hot.parents
2019,1,WCR2019_0970,2,WCR2019_0223,WCR2019_0327,within-group subordinate,within-group subordinate,49,21,28,19,19,40,40,1,99999,488,828,473,0.434225844004657,0,0,NA,NA,none,hothiphop.parents,hot.parents
2019,1,WCR2019_0970,3,WCR2019_0440,WCR2019_0122,within-group subordinate,within-group subordinate,52,21,31,24,17,45,38,1,99999,568,847,562,0.434225844004657,0,0,NA,NA,none,hothiphop.parents,hot.parents
2019,1,WCR2019_0972,1,WCR2019_0223,WCR2019_0087,within-group subordinate,within-group subordinate,73,27,46,36,48,63,75,1,99999,487,626,355,0.383449883449883,0,0,NA,NA,none,hothiphop.parents,hot.parents
2019,1,WCR2019_0972,2,WCR2019_0223,WCR2019_0061,within-group subordinate,within-group subordinate,78,35,43,36,38,71,73,1,99999,487,760,424,0.383449883449883,0,0,NA,NA,none,hothiphop.parents,hot.parents
2019,1,WCR2019_0972,3,WCR2019_0440,WCR2019_0087,within-group subordinate,within-group subordinate,80,34,46,35,48,69,82,1,99999,567,626,413,0.383449883449883,0,0,NA,NA,none,hothiphop.parents,hot.parents
2019,1,WCR2019_0973,1,WCR2019_0390,WCR2019_0213,within-group subordinate,within-group subordinate,3,0,3,1,2,1,2,1,99999,854,847,847,0.377049180327869,0,0,NA,NA,none,hothiphop.parents,hot.parents
2019,1,WCR2019_0973,2,WCR2019_0390,WCR2019_0122,within-group subordinate,within-group subordinate,53,32,21,1,20,33,52,1,99999,854,842,842,0.377049180327869,0,0,NA,NA,none,hothiphop.parents,hot.parents
2019,1,WCR2019_0973,3,WCR2019_0440,WCR2019_0213,within-group subordinate,within-group subordinate,55,26,29,28,2,54,28,1,99999,565,847,560,0.377049180327869,0,0,NA,NA,none,hothiphop.parents,hot.parents
2019,1,WCR2019_0974,1,WCR2019_0223,WCR2019_0279,within-group subordinate,within-group subordinate,54,28,26,24,4,52,32,1,99999,483,849,482,0.359484777517564,0,0,NA,NA,none,hothiphop.parents,hot.parents
2019,1,WCR2019_0974,2,WCR2019_0223,WCR2019_0087,within-group subordinate,within-group subordinate,63,24,39,24,50,48,74,1,99999,483,622,351,0.359484777517564,0,0,NA,NA,none,hothiphop.parents,hot.parents
2019,1,WCR2019_0974,3,WCR2019_0440,WCR2019_0279,within-group subordinate,within-group subordinate,64,36,28,27,4,63,40,1,99999,564,849,563,0.359484777517564,0,0,NA,NA,none,hothiphop.parents,hot.parents
2019,1,WCR2019_0975,1,WCR2019_0223,WCR2019_0087,within-group subordinate,within-group subordinate,52,16,36,28,41,44,57,1,99999,486,623,354,0.384074941451991,0,0,NA,NA,none,hothiphop.parents,hot.parents
2019,1,WCR2019_0975,2,WCR2019_0223,WCR2019_0061,within-group subordinate,within-group subordinate,61,24,37,28,41,52,65,1,99999,486,756,423,0.384074941451991,0,0,NA,NA,none,hothiphop.parents,hot.parents
2019,1,WCR2019_0975,3,WCR2019_0223,WCR2019_0161,within-group subordinate,within-group subordinate,63,28,35,28,33,56,61,1,99999,486,805,467,0.384074941451991,0,0,NA,NA,none,hothiphop.parents,hot.parents
2019,1,WCR2019_0977,1,WCR2019_0324,WCR2019_0258,within-group subordinate,within-group subordinate,7,3,4,3,1,6,4,1,99999,855,842,840,0.176196032672112,0,0,NA,NA,none,hothiphop.parents,hot.parents
2019,1,WCR2019_0977,2,WCR2019_0474,WCR2019_0258,within-group subordinate,within-group subordinate,7,3,4,3,1,6,4,1,99999,736,842,722,0.176196032672112,0,0,NA,NA,none,hothiphop.parents,hot.parents
2019,1,WCR2019_0977,3,WCR2019_0256,WCR2019_0258,within-group subordinate,within-group subordinate,7,1,6,5,1,6,2,1,99999,854,842,839,0.176196032672112,0,0,NA,NA,none,hothiphop.parents,hot.parents
2019,1,WCR2019_0978,1,WCR2019_0223,WCR2019_0539,within-group subordinate,within-group subordinate,53,27,26,23,5,50,32,1,99999,484,837,479,0.381345926800472,0,0,NA,NA,none,hothiphop.parents,hot.parents
2019,1,WCR2019_0978,2,WCR2019_0223,WCR2019_0075,within-group subordinate,within-group subordinate,54,29,25,23,28,52,57,1,99999,484,739,415,0.381345926800472,0,0,NA,NA,none,hothiphop.parents,hot.parents
2019,1,WCR2019_0978,3,WCR2019_0440,WCR2019_0539,within-group subordinate,within-group subordinate,55,27,28,27,5,54,32,1,99999,565,837,556,0.381345926800472,0,0,NA,NA,none,hothiphop.parents,hot.parents
2019,1,WCR2019_0980,1,WCR2019_0474,WCR2019_0516,within-group subordinate,within-group subordinate,7,3,4,3,3,6,6,1,99999,730,844,722,0.480046948356808,0,0,NA,NA,none,hothiphop.parents,hot.parents
2019,1,WCR2019_0980,2,WCR2019_0324,WCR2019_0516,within-group subordinate,within-group subordinate,10,6,4,1,3,7,9,1,99999,850,844,842,0.480046948356808,0,0,NA,NA,none,hothiphop.parents,hot.parents
2019,1,WCR2019_0980,3,WCR2019_0479,WCR2019_0516,within-group subordinate,within-group subordinate,11,8,3,0,3,8,11,1,99999,848,844,840,0.480046948356808,0,0,NA,NA,none,hothiphop.parents,hot.parents
2019,1,WCR2019_0981,1,WCR2019_0223,WCR2019_0087,within-group subordinate,within-group subordinate,68,26,42,31,44,57,70,1,99999,488,625,355,0.375291375291375,0,0,NA,NA,none,hothiphop.parents,hot.parents
2019,1,WCR2019_0981,2,WCR2019_0223,WCR2019_0061,within-group subordinate,within-group subordinate,70,31,39,31,35,62,66,1,99999,488,761,426,0.375291375291375,0,0,NA,NA,none,hothiphop.parents,hot.parents
2019,1,WCR2019_0981,3,WCR2019_0440,WCR2019_0061,within-group subordinate,within-group subordinate,72,38,34,27,35,65,73,1,99999,568,761,502,0.375291375291375,0,0,NA,NA,none,hothiphop.parents,hot.parents
2019,1,WCR2019_0982,1,WCR2019_0421,WCR2019_0388,within-group subordinate,within-group subordinate,2,0,2,1,1,1,1,1,99999,858,857,856,0.359720605355064,0,0,NA,NA,none,hothiphop.parents,hot.parents
2019,1,WCR2019_0982,2,WCR2019_0421,WCR2019_0088,within-group subordinate,within-group subordinate,4,4,0,1,0,5,4,1,99999,858,645,644,0.359720605355064,0,0,NA,NA,none,hothiphop.parents,hot.parents
2019,1,WCR2019_0982,3,WCR2019_0421,WCR2019_0039,within-group subordinate,within-group subordinate,7,5,2,1,1,6,6,1,99999,858,837,836,0.359720605355064,0,0,NA,NA,none,hothiphop.parents,hot.parents
2019,1,WCR2019_0983,1,WCR2019_0440,WCR2019_0122,within-group subordinate,within-group subordinate,53,23,30,19,18,42,41,1,99999,540,795,534,0.40272614622057,0,0,NA,NA,none,hothiphop.parents,hot.parents
2019,1,WCR2019_0983,2,WCR2019_0223,WCR2019_0088,within-group subordinate,within-group subordinate,57,25,32,28,22,53,47,1,99999,455,611,358,0.40272614622057,0,0,NA,NA,none,hothiphop.parents,hot.parents
2019,1,WCR2019_0983,3,WCR2019_0440,WCR2019_0327,within-group subordinate,within-group subordinate,59,37,22,19,11,56,48,1,99999,540,779,523,0.40272614622057,0,0,NA,NA,none,hothiphop.parents,hot.parents
2019,1,WCR2019_0984,1,WCR2019_0280,WCR2019_0537,within-group subordinate,within-group subordinate,3,0,3,0,3,0,3,1,99999,834,849,830,0.370457209847597,0,0,NA,NA,none,hothiphop.parents,hot.parents
2019,1,WCR2019_0984,2,WCR2019_0280,WCR2019_0327,within-group subordinate,within-group subordinate,41,29,12,0,12,29,41,1,99999,834,822,805,0.370457209847597,0,0,NA,NA,none,hothiphop.parents,hot.parents
2019,1,WCR2019_0984,3,WCR2019_0223,WCR2019_0088,within-group subordinate,within-group subordinate,43,20,23,19,23,39,43,1,99999,486,640,378,0.370457209847597,0,0,NA,NA,none,hothiphop.parents,hot.parents
2019,1,WCR2019_0985,1,WCR2019_0421,WCR2019_0258,within-group subordinate,within-group subordinate,0,0,0,0,0,0,0,1,99999,858,844,843,0.311990686845169,0,0,NA,NA,none,hothiphop.parents,hot.parents
2019,1,WCR2019_0985,2,WCR2019_0421,WCR2019_0327,within-group subordinate,within-group subordinate,38,30,8,0,8,30,38,1,99999,858,828,827,0.311990686845169,0,0,NA,NA,none,hothiphop.parents,hot.parents
2019,1,WCR2019_0985,3,WCR2019_0421,WCR2019_0417,within-group subordinate,within-group subordinate,40,30,10,0,10,30,40,1,99999,858,856,855,0.311990686845169,0,0,NA,NA,none,hothiphop.parents,hot.parents
2019,1,WCR2019_0986,1,WCR2019_0223,WCR2019_0087,within-group subordinate,within-group subordinate,62,29,33,26,40,55,69,1,99999,485,627,356,0.399532710280374,0,0,NA,NA,none,hothiphop.parents,hot.parents
2019,1,WCR2019_0986,2,WCR2019_0223,WCR2019_0061,within-group subordinate,within-group subordinate,63,32,31,26,32,58,64,1,99999,485,760,424,0.399532710280374,0,0,NA,NA,none,hothiphop.parents,hot.parents
2019,1,WCR2019_0986,3,WCR2019_0223,WCR2019_0327,within-group subordinate,within-group subordinate,69,36,33,26,26,62,62,1,99999,485,825,470,0.399532710280374,0,0,NA,NA,none,hothiphop.parents,hot.parents
2019,1,WCR2019_0987,1,WCR2019_0223,WCR2019_0327,within-group subordinate,within-group subordinate,42,23,19,20,6,43,29,1,99999,487,826,472,0.43757292882147,0,0,NA,NA,none,hothiphop.parents,hot.parents
2019,1,WCR2019_0987,2,WCR2019_0440,WCR2019_0122,within-group subordinate,within-group subordinate,50,27,23,13,17,40,44,1,99999,566,845,560,0.43757292882147,0,0,NA,NA,none,hothiphop.parents,hot.parents
2019,1,WCR2019_0987,3,WCR2019_0440,WCR2019_0327,within-group subordinate,within-group subordinate,52,38,14,13,6,51,44,1,99999,566,826,546,0.43757292882147,0,0,NA,NA,none,hothiphop.parents,hot.parents
2019,1,WCR2019_0988,1,WCR2019_0223,WCR2019_0161,within-group subordinate,within-group subordinate,43,19,24,20,18,39,37,1,99999,484,804,465,0.38056206088993,0,0,NA,NA,none,hothiphop.parents,hot.parents
2019,1,WCR2019_0988,2,WCR2019_0223,WCR2019_0327,within-group subordinate,within-group subordinate,47,23,24,20,19,43,42,1,99999,484,823,469,0.38056206088993,0,0,NA,NA,none,hothiphop.parents,hot.parents
2019,1,WCR2019_0988,3,WCR2019_0223,WCR2019_0087,within-group subordinate,within-group subordinate,47,20,27,20,44,40,64,1,99999,484,624,353,0.38056206088993,0,0,NA,NA,none,hothiphop.parents,hot.parents
2019,1,WCR2019_0989,1,WCR2019_0223,WCR2019_0087,within-group subordinate,within-group subordinate,49,13,36,26,42,39,55,1,99999,440,562,318,0.320209973753281,0,0,NA,NA,none,hothiphop.parents,hot.parents
2019,1,WCR2019_0989,2,WCR2019_0223,WCR2019_0327,within-group subordinate,within-group subordinate,64,28,36,26,25,54,53,1,99999,440,734,427,0.320209973753281,0,0,NA,NA,none,hothiphop.parents,hot.parents
2019,1,WCR2019_0989,3,WCR2019_0223,WCR2019_0171,within-group subordinate,within-group subordinate,66,27,39,26,48,53,75,1,99999,440,734,423,0.320209973753281,0,0,NA,NA,none,hothiphop.parents,hot.parents
2019,1,WCR2019_0991,1,WCR2019_0223,WCR2019_0327,within-group subordinate,within-group subordinate,46,21,25,22,15,43,36,1,99999,488,828,473,0.357392316647264,0,0,NA,NA,none,hothiphop.parents,hot.parents
2019,1,WCR2019_0991,2,WCR2019_0223,WCR2019_0161,within-group subordinate,within-group subordinate,52,24,28,22,27,46,51,1,99999,488,809,469,0.357392316647264,0,0,NA,NA,none,hothiphop.parents,hot.parents
2019,1,WCR2019_0991,3,WCR2019_0223,WCR2019_0407,within-group subordinate,within-group subordinate,53,25,28,22,23,47,48,1,99999,488,853,484,0.357392316647264,0,0,NA,NA,none,hothiphop.parents,hot.parents
2019,1,WCR2019_0992,1,WCR2019_0223,WCR2019_0087,within-group subordinate,within-group subordinate,58,21,37,27,37,48,58,1,99999,486,625,356,0.378220140515222,0,0,NA,NA,none,hothiphop.parents,hot.parents
2019,1,WCR2019_0992,2,WCR2019_0223,WCR2019_0061,within-group subordinate,within-group subordinate,63,28,35,27,34,55,62,1,99999,486,757,424,0.378220140515222,0,0,NA,NA,none,hothiphop.parents,hot.parents
2019,1,WCR2019_0992,3,WCR2019_0440,WCR2019_0087,within-group subordinate,within-group subordinate,63,28,35,20,37,48,65,1,99999,565,625,412,0.378220140515222,0,0,NA,NA,none,hothiphop.parents,hot.parents
2019,1,WCR2019_0993,1,WCR2019_0223,WCR2019_0087,within-group subordinate,within-group subordinate,70,20,50,36,47,56,67,1,99999,483,620,351,0.374853113983549,0,0,NA,NA,none,hothiphop.parents,hot.parents
2019,1,WCR2019_0993,2,WCR2019_0585,WCR2019_0327,within-group subordinate,within-group subordinate,71,43,28,2,28,45,71,1,99999,851,821,821,0.374853113983549,0,0,NA,NA,none,hothiphop.parents,hot.parents
2019,1,WCR2019_0993,3,WCR2019_0223,WCR2019_0073,within-group subordinate,within-group subordinate,75,27,48,36,48,63,75,1,99999,483,780,433,0.374853113983549,0,0,NA,NA,none,hothiphop.parents,hot.parents
2019,1,WCR2019_0996,1,WCR2019_0223,WCR2019_0087,within-group subordinate,within-group subordinate,57,25,32,24,46,49,71,1,99999,488,625,356,0.40303738317757,0,0,NA,NA,none,hothiphop.parents,hot.parents
2019,1,WCR2019_0996,2,WCR2019_0223,WCR2019_0327,within-group subordinate,within-group subordinate,63,32,31,24,28,56,60,1,99999,488,825,473,0.40303738317757,0,0,NA,NA,none,hothiphop.parents,hot.parents
2019,1,WCR2019_0996,3,WCR2019_0223,WCR2019_0061,within-group subordinate,within-group subordinate,68,33,35,24,44,57,77,1,99999,488,759,425,0.40303738317757,0,0,NA,NA,none,hothiphop.parents,hot.parents
2019,1,WCR2019_0997,1,WCR2019_0337,WCR2019_0088,within-group subordinate,within-group subordinate,25,4,21,15,11,19,15,1,99999,700,534,531,0.38122332859175,0,0,NA,NA,none,hothiphop.parents,hot.parents
2019,1,WCR2019_0997,2,WCR2019_0337,WCR2019_0039,within-group subordinate,within-group subordinate,28,4,24,15,9,19,13,1,99999,700,688,685,0.38122332859175,0,0,NA,NA,none,hothiphop.parents,hot.parents
2019,1,WCR2019_0997,3,WCR2019_0337,WCR2019_0047,within-group subordinate,within-group subordinate,28,4,24,15,9,19,13,1,99999,700,702,699,0.38122332859175,0,0,NA,NA,none,hothiphop.parents,hot.parents
2019,1,WCR2019_1000,1,WCR2019_0263,WCR2019_0461,within-group subordinate,within-group subordinate,26,14,12,10,2,24,16,1,99999,820,824,816,0.444444444444444,0,0,NA,NA,none,hothiphop.parents,hot.parents
2019,1,WCR2019_1000,2,WCR2019_0165,WCR2019_0461,within-group subordinate,within-group subordinate,30,17,13,11,2,28,19,1,99999,822,824,818,0.444444444444444,0,0,NA,NA,none,hothiphop.parents,hot.parents
2019,1,WCR2019_1000,3,WCR2019_0338,WCR2019_0461,within-group subordinate,within-group subordinate,30,16,14,13,2,29,18,1,99999,824,824,821,0.444444444444444,0,0,NA,NA,none,hothiphop.parents,hot.parents
2019,1,WCR2019_1001,1,WCR2019_0223,WCR2019_0122,within-group subordinate,within-group subordinate,49,29,20,15,13,44,42,1,99999,486,846,480,0.438739789964994,0,0,NA,NA,none,hothiphop.parents,hot.parents
2019,1,WCR2019_1001,2,WCR2019_0223,WCR2019_0075,within-group subordinate,within-group subordinate,50,30,20,15,28,45,58,1,99999,486,747,416,0.438739789964994,0,0,NA,NA,none,hothiphop.parents,hot.parents
2019,1,WCR2019_1001,3,WCR2019_0223,WCR2019_0327,within-group subordinate,within-group subordinate,51,30,21,15,19,45,49,1,99999,486,826,471,0.438739789964994,0,0,NA,NA,none,hothiphop.parents,hot.parents
2019,1,WCR2019_1003,1,WCR2019_0223,WCR2019_0516,within-group subordinate,within-group subordinate,61,32,29,29,3,61,35,1,99999,484,844,482,0.400234741784038,0,0,NA,NA,none,hothiphop.parents,hot.parents
2019,1,WCR2019_1003,2,WCR2019_0223,WCR2019_0087,within-group subordinate,within-group subordinate,61,28,33,29,30,57,58,1,99999,484,619,351,0.400234741784038,0,0,NA,NA,none,hothiphop.parents,hot.parents
2019,1,WCR2019_1003,3,WCR2019_0440,WCR2019_0516,within-group subordinate,within-group subordinate,69,41,28,26,3,67,44,1,99999,563,844,559,0.400234741784038,0,0,NA,NA,none,hothiphop.parents,hot.parents
2019,1,WCR2019_1005,1,WCR2019_0223,WCR2019_0088,within-group subordinate,within-group subordinate,46,23,23,12,31,35,54,1,99999,488,645,381,0.447552447552448,0,0,NA,NA,none,hothiphop.parents,hot.parents
2019,1,WCR2019_1005,2,WCR2019_0223,WCR2019_0327,within-group subordinate,within-group subordinate,49,33,16,12,21,45,54,1,99999,488,827,473,0.447552447552448,0,0,NA,NA,none,hothiphop.parents,hot.parents
2019,1,WCR2019_1005,3,WCR2019_0223,WCR2019_0122,within-group subordinate,within-group subordinate,50,32,18,12,18,44,50,1,99999,488,846,481,0.447552447552448,0,0,NA,NA,none,hothiphop.parents,hot.parents
2019,1,WCR2019_1008,1,WCR2019_0223,WCR2019_0088,within-group subordinate,within-group subordinate,30,26,4,6,1,32,27,1,99999,482,638,375,0.484136310223267,0,0,NA,NA,none,hothiphop.parents,hot.parents
2019,1,WCR2019_1008,2,WCR2019_0223,WCR2019_0122,within-group subordinate,within-group subordinate,36,29,7,6,1,35,30,1,99999,482,839,475,0.484136310223267,0,0,NA,NA,none,hothiphop.parents,hot.parents
2019,1,WCR2019_1008,3,WCR2019_0223,WCR2019_0327,within-group subordinate,within-group subordinate,36,28,8,6,3,34,31,1,99999,482,820,467,0.484136310223267,0,0,NA,NA,none,hothiphop.parents,hot.parents
2019,1,WCR2019_1010,1,WCR2019_0223,WCR2019_0087,within-group subordinate,within-group subordinate,60,20,40,28,53,48,73,1,99999,482,622,352,0.354534746760895,0,0,NA,NA,none,hothiphop.parents,hot.parents
2019,1,WCR2019_1010,2,WCR2019_0223,WCR2019_0161,within-group subordinate,within-group subordinate,68,33,35,28,34,61,67,1,99999,482,802,465,0.354534746760895,0,0,NA,NA,none,hothiphop.parents,hot.parents
2019,1,WCR2019_1010,3,WCR2019_0223,WCR2019_0061,within-group subordinate,within-group subordinate,71,27,44,28,45,55,72,1,99999,482,754,421,0.354534746760895,0,0,NA,NA,none,hothiphop.parents,hot.parents
2019,1,WCR2019_1011,1,WCR2019_0223,WCR2019_0087,within-group subordinate,within-group subordinate,68,29,39,30,42,59,71,1,99999,484,624,353,0.385964912280702,0,0,NA,NA,none,hothiphop.parents,hot.parents
2019,1,WCR2019_1011,2,WCR2019_0440,WCR2019_0087,within-group subordinate,within-group subordinate,70,19,51,37,42,56,61,1,99999,566,624,411,0.385964912280702,0,0,NA,NA,none,hothiphop.parents,hot.parents
2019,1,WCR2019_1011,3,WCR2019_0223,WCR2019_0516,within-group subordinate,within-group subordinate,71,41,30,30,2,71,43,1,99999,484,847,482,0.385964912280702,0,0,NA,NA,none,hothiphop.parents,hot.parents
2019,1,WCR2019_1012,1,WCR2019_0223,WCR2019_0088,within-group subordinate,within-group subordinate,35,21,14,15,4,36,25,1,99999,487,645,381,0.466744457409568,0,0,NA,NA,none,hothiphop.parents,hot.parents
2019,1,WCR2019_1012,2,WCR2019_0223,WCR2019_0327,within-group subordinate,within-group subordinate,42,26,16,15,3,41,29,1,99999,487,826,472,0.466744457409568,0,0,NA,NA,none,hothiphop.parents,hot.parents
2019,1,WCR2019_1012,3,WCR2019_0223,WCR2019_0061,within-group subordinate,within-group subordinate,45,29,16,15,9,44,38,1,99999,487,759,424,0.466744457409568,0,0,NA,NA,none,hothiphop.parents,hot.parents
2019,1,WCR2019_1013,1,WCR2019_0440,WCR2019_0327,within-group subordinate,within-group subordinate,50,30,20,18,6,48,36,1,99999,557,815,538,0.389349112426035,0,0,NA,NA,none,hothiphop.parents,hot.parents
2019,1,WCR2019_1013,2,WCR2019_0223,WCR2019_0327,within-group subordinate,within-group subordinate,53,28,25,24,6,52,34,1,99999,478,815,464,0.389349112426035,0,0,NA,NA,none,hothiphop.parents,hot.parents
2019,1,WCR2019_1013,3,WCR2019_0223,WCR2019_0061,within-group subordinate,within-group subordinate,53,26,27,24,21,50,47,1,99999,478,750,418,0.389349112426035,0,0,NA,NA,none,hothiphop.parents,hot.parents
2019,1,WCR2019_1014,1,WCR2019_0420,WCR2019_0325,within-group subordinate,within-group subordinate,1,0,1,1,0,1,0,1,99999,752,744,743,0.0969455511288181,0,0,NA,NA,none,hothiphop.parents,hot.parents
2019,1,WCR2019_1014,2,WCR2019_0252,WCR2019_0325,within-group subordinate,within-group subordinate,4,2,2,2,0,4,2,1,99999,750,744,741,0.0969455511288181,0,0,NA,NA,none,hothiphop.parents,hot.parents
2019,1,WCR2019_1014,3,WCR2019_0409,WCR2019_0325,within-group subordinate,within-group subordinate,4,2,2,2,0,4,2,1,99999,749,744,741,0.0969455511288181,0,0,NA,NA,none,hothiphop.parents,hot.parents
2019,1,WCR2019_1015,1,WCR2019_0223,WCR2019_0087,within-group subordinate,within-group subordinate,51,16,35,28,39,44,55,1,99999,489,627,356,0.380232558139535,0,0,NA,NA,none,hothiphop.parents,hot.parents
2019,1,WCR2019_1015,2,WCR2019_0440,WCR2019_0087,within-group subordinate,within-group subordinate,65,20,45,27,39,47,59,1,99999,569,627,414,0.380232558139535,0,0,NA,NA,none,hothiphop.parents,hot.parents
2019,1,WCR2019_1015,3,WCR2019_0223,WCR2019_0161,within-group subordinate,within-group subordinate,72,36,36,28,35,64,71,1,99999,489,810,470,0.380232558139535,0,0,NA,NA,none,hothiphop.parents,hot.parents
2019,1,WCR2019_1016,1,WCR2019_0440,WCR2019_0327,within-group subordinate,within-group subordinate,62,36,26,22,24,58,60,1,99999,568,826,548,0.374562427071179,0,0,NA,NA,none,hothiphop.parents,hot.parents
2019,1,WCR2019_1016,2,WCR2019_0440,WCR2019_0087,within-group subordinate,within-group subordinate,64,27,37,22,31,49,58,1,99999,568,624,413,0.374562427071179,0,0,NA,NA,none,hothiphop.parents,hot.parents
2019,1,WCR2019_1016,3,WCR2019_0223,WCR2019_0087,within-group subordinate,within-group subordinate,65,26,39,27,31,53,57,1,99999,488,624,355,0.374562427071179,0,0,NA,NA,none,hothiphop.parents,hot.parents
2019,1,WCR2019_1017,1,WCR2019_0252,WCR2019_0088,within-group subordinate,within-group subordinate,5,1,4,3,4,4,5,1,99999,849,642,640,0.0516431924882629,0,0,NA,NA,none,hothiphop.parents,hot.parents
2019,1,WCR2019_1017,2,WCR2019_0420,WCR2019_0088,within-group subordinate,within-group subordinate,6,1,5,3,4,4,5,1,99999,851,642,641,0.0516431924882629,0,0,NA,NA,none,hothiphop.parents,hot.parents
2019,1,WCR2019_1017,3,WCR2019_0535,WCR2019_0088,within-group subordinate,within-group subordinate,6,1,5,5,4,6,5,1,99999,847,642,639,0.0516431924882629,0,0,NA,NA,none,hothiphop.parents,hot.parents
2019,1,WCR2019_1018,1,WCR2019_0223,WCR2019_0087,within-group subordinate,within-group subordinate,51,21,30,21,45,42,66,1,99999,468,617,349,0.428226779252111,0,0,NA,NA,none,hothiphop.parents,hot.parents
2019,1,WCR2019_1018,2,WCR2019_0223,WCR2019_0047,within-group subordinate,within-group subordinate,56,34,22,21,2,55,36,1,99999,468,828,467,0.428226779252111,0,0,NA,NA,none,hothiphop.parents,hot.parents
2019,1,WCR2019_1018,3,WCR2019_0223,WCR2019_0161,within-group subordinate,within-group subordinate,56,30,26,21,18,51,48,1,99999,468,781,450,0.428226779252111,0,0,NA,NA,none,hothiphop.parents,hot.parents
2019,1,WCR2019_1019,1,WCR2019_0223,WCR2019_0088,within-group subordinate,within-group subordinate,38,18,20,19,14,37,32,1,99999,484,640,379,0.425882352941176,0,0,NA,NA,none,hothiphop.parents,hot.parents
2019,1,WCR2019_1019,2,WCR2019_0223,WCR2019_0327,within-group subordinate,within-group subordinate,44,22,22,19,11,41,33,1,99999,484,819,469,0.425882352941176,0,0,NA,NA,none,hothiphop.parents,hot.parents
2019,1,WCR2019_1019,3,WCR2019_0223,WCR2019_0075,within-group subordinate,within-group subordinate,48,26,22,19,19,45,45,1,99999,484,743,416,0.425882352941176,0,0,NA,NA,none,hothiphop.parents,hot.parents
2019,1,WCR2019_1020,1,WCR2019_0212,WCR2019_0206,within-group subordinate,within-group subordinate,7,1,6,4,3,5,4,1,99999,843,844,833,0.435747663551402,0,0,NA,NA,none,hothiphop.parents,hot.parents
2019,1,WCR2019_1020,2,WCR2019_0212,WCR2019_0327,within-group subordinate,within-group subordinate,36,19,17,4,14,23,33,1,99999,843,825,814,0.435747663551402,0,0,NA,NA,none,hothiphop.parents,hot.parents
2019,1,WCR2019_1020,3,WCR2019_0212,WCR2019_0088,within-group subordinate,within-group subordinate,36,14,22,4,19,18,33,1,99999,843,643,632,0.435747663551402,0,0,NA,NA,none,hothiphop.parents,hot.parents
2019,1,WCR2019_1021,1,WCR2019_0064,WCR2019_0088,within-group subordinate,within-group subordinate,5,2,3,3,3,5,5,1,99999,630,634,526,0.0554245283018868,0,0,NA,NA,none,hothiphop.parents,hot.parents
2019,1,WCR2019_1021,2,WCR2019_0252,WCR2019_0088,within-group subordinate,within-group subordinate,5,1,4,2,3,3,4,1,99999,845,634,632,0.0554245283018868,0,0,NA,NA,none,hothiphop.parents,hot.parents
2019,1,WCR2019_1021,3,WCR2019_0252,WCR2019_0157,within-group subordinate,within-group subordinate,5,1,4,2,3,3,4,1,99999,845,841,838,0.0554245283018868,0,0,NA,NA,none,hothiphop.parents,hot.parents
2019,1,WCR2019_1022,1,WCR2019_0252,WCR2019_0088,within-group subordinate,within-group subordinate,8,1,7,4,7,5,8,1,99999,825,620,619,0.0483675937122128,0,0,NA,NA,none,hothiphop.parents,hot.parents
2019,1,WCR2019_1022,2,WCR2019_0252,WCR2019_0157,within-group subordinate,within-group subordinate,8,1,7,4,5,5,6,1,99999,825,820,818,0.0483675937122128,0,0,NA,NA,none,hothiphop.parents,hot.parents
2019,1,WCR2019_1022,3,WCR2019_0252,WCR2019_0398,within-group subordinate,within-group subordinate,8,1,7,4,4,5,5,1,99999,825,826,824,0.0483675937122128,0,0,NA,NA,none,hothiphop.parents,hot.parents
2019,1,WCR2019_1023,1,WCR2019_0440,WCR2019_0122,within-group subordinate,within-group subordinate,69,27,42,27,40,54,67,1,99999,567,843,561,0.394152046783626,0,0,NA,NA,none,hothiphop.parents,hot.parents
2019,1,WCR2019_1023,2,WCR2019_0440,WCR2019_0087,within-group subordinate,within-group subordinate,71,35,36,27,42,62,77,1,99999,567,622,412,0.394152046783626,0,0,NA,NA,none,hothiphop.parents,hot.parents
2019,1,WCR2019_1023,3,WCR2019_0223,WCR2019_0087,within-group subordinate,within-group subordinate,71,28,43,35,42,63,70,1,99999,486,622,353,0.394152046783626,0,0,NA,NA,none,hothiphop.parents,hot.parents
2019,1,WCR2019_1024,1,WCR2019_0536,WCR2019_0463,within-group subordinate,within-group subordinate,2,1,1,1,0,2,1,1,99999,827,843,827,0.422301304863582,0,0,NA,NA,none,hothiphop.parents,hot.parents
2019,1,WCR2019_1024,2,WCR2019_0440,WCR2019_0463,within-group subordinate,within-group subordinate,54,33,21,21,0,54,33,1,99999,555,843,555,0.422301304863582,0,0,NA,NA,none,hothiphop.parents,hot.parents
2019,1,WCR2019_1024,3,WCR2019_0223,WCR2019_0463,within-group subordinate,within-group subordinate,58,37,21,21,0,58,37,1,99999,476,843,476,0.422301304863582,0,0,NA,NA,none,hothiphop.parents,hot.parents
2019,1,WCR2019_1026,1,WCR2019_0064,WCR2019_0039,within-group subordinate,within-group subordinate,7,4,3,2,4,6,8,1,99999,637,831,628,0.0586166471277843,0,0,NA,NA,none,hothiphop.parents,hot.parents
2019,1,WCR2019_1026,2,WCR2019_0252,WCR2019_0398,within-group subordinate,within-group subordinate,7,3,4,3,2,6,5,1,99999,850,852,849,0.0586166471277843,0,0,NA,NA,none,hothiphop.parents,hot.parents
2019,1,WCR2019_1026,3,WCR2019_0252,WCR2019_0157,within-group subordinate,within-group subordinate,7,2,5,3,4,5,6,1,99999,850,846,843,0.0586166471277843,0,0,NA,NA,none,hothiphop.parents,hot.parents
2019,1,WCR2019_1027,1,WCR2019_0223,WCR2019_0073,within-group subordinate,within-group subordinate,59,23,36,23,47,46,70,1,99999,487,784,436,0.394859813084112,0,0,NA,NA,none,hothiphop.parents,hot.parents
2019,1,WCR2019_1027,2,WCR2019_0223,WCR2019_0087,within-group subordinate,within-group subordinate,64,28,36,23,33,51,61,1,99999,487,624,354,0.394859813084112,0,0,NA,NA,none,hothiphop.parents,hot.parents
2019,1,WCR2019_1027,3,WCR2019_0440,WCR2019_0087,within-group subordinate,within-group subordinate,66,30,36,18,33,48,63,1,99999,566,624,412,0.394859813084112,0,0,NA,NA,none,hothiphop.parents,hot.parents
2019,1,WCR2019_1028,1,WCR2019_0420,WCR2019_0325,within-group subordinate,within-group subordinate,1,0,1,0,1,0,1,1,99999,845,837,836,0.131205673758865,0,0,NA,NA,none,hothiphop.parents,hot.parents
2019,1,WCR2019_1028,2,WCR2019_0334,WCR2019_0325,within-group subordinate,within-group subordinate,6,3,3,2,1,5,4,1,99999,843,837,835,0.131205673758865,0,0,NA,NA,none,hothiphop.parents,hot.parents
2019,1,WCR2019_1028,3,WCR2019_0474,WCR2019_0325,within-group subordinate,within-group subordinate,6,0,6,5,1,5,1,1,99999,725,837,718,0.131205673758865,0,0,NA,NA,none,hothiphop.parents,hot.parents
2019,1,WCR2019_1029,1,WCR2019_0223,WCR2019_0061,within-group subordinate,within-group subordinate,53,24,29,20,35,44,59,1,99999,487,758,424,0.351635514018692,0,0,NA,NA,none,hothiphop.parents,hot.parents
2019,1,WCR2019_1029,2,WCR2019_0223,WCR2019_0087,within-group subordinate,within-group subordinate,54,17,37,20,50,37,67,1,99999,487,624,355,0.351635514018692,0,0,NA,NA,none,hothiphop.parents,hot.parents
2019,1,WCR2019_1029,3,WCR2019_0223,WCR2019_0327,within-group subordinate,within-group subordinate,55,21,34,20,33,41,54,1,99999,487,825,472,0.351635514018692,0,0,NA,NA,none,hothiphop.parents,hot.parents
2019,1,WCR2019_1030,1,WCR2019_0223,WCR2019_0087,within-group subordinate,within-group subordinate,57,23,34,26,41,49,64,1,99999,487,626,355,0.384615384615385,0,0,NA,NA,none,hothiphop.parents,hot.parents
2019,1,WCR2019_1030,2,WCR2019_0223,WCR2019_0073,within-group subordinate,within-group subordinate,63,25,38,26,47,51,72,1,99999,487,786,436,0.384615384615385,0,0,NA,NA,none,hothiphop.parents,hot.parents
2019,1,WCR2019_1030,3,WCR2019_0223,WCR2019_0327,within-group subordinate,within-group subordinate,66,33,33,26,28,59,61,1,99999,487,827,472,0.384615384615385,0,0,NA,NA,none,hothiphop.parents,hot.parents
2019,1,WCR2019_1076,1,WCR2019_0223,WCR2019_0088,within-group subordinate,within-group subordinate,47,25,22,16,25,41,50,1,99999,489,643,381,0.409568261376896,0,0,NA,NA,none,hothiphop.parents,hot.parents
2019,1,WCR2019_1076,2,WCR2019_0223,WCR2019_0075,within-group subordinate,within-group subordinate,51,29,22,16,21,45,50,1,99999,489,747,419,0.409568261376896,0,0,NA,NA,none,hothiphop.parents,hot.parents
2019,1,WCR2019_1076,3,WCR2019_0223,WCR2019_0327,within-group subordinate,within-group subordinate,58,31,27,16,21,47,52,1,99999,489,826,474,0.409568261376896,0,0,NA,NA,none,hothiphop.parents,hot.parents
2019,1,WCR2019_1078,1,WCR2019_0420,WCR2019_0405,within-group subordinate,within-group subordinate,0,0,0,0,0,0,0,1,99999,833,786,785,0.0479616306954436,0,0,NA,NA,none,hothiphop.parents,hot.parents
2019,1,WCR2019_1078,2,WCR2019_0474,WCR2019_0405,within-group subordinate,within-group subordinate,1,0,1,1,0,1,0,1,99999,716,786,675,0.0479616306954436,0,0,NA,NA,none,hothiphop.parents,hot.parents
2019,1,WCR2019_1078,3,WCR2019_0409,WCR2019_0405,within-group subordinate,within-group subordinate,3,2,1,3,0,5,2,1,99999,829,786,781,0.0479616306954436,0,0,NA,NA,none,hothiphop.parents,hot.parents
2019,1,WCR2019_1079,1,WCR2019_0223,WCR2019_0061,within-group subordinate,within-group subordinate,58,24,34,27,32,51,56,1,99999,472,736,411,0.35421686746988,0,0,NA,NA,none,hothiphop.parents,hot.parents
2019,1,WCR2019_1079,2,WCR2019_0223,WCR2019_0087,within-group subordinate,within-group subordinate,60,25,35,27,39,52,64,1,99999,472,612,346,0.35421686746988,0,0,NA,NA,none,hothiphop.parents,hot.parents
2019,1,WCR2019_1079,3,WCR2019_0223,WCR2019_0327,within-group subordinate,within-group subordinate,65,30,35,27,21,57,51,1,99999,472,800,458,0.35421686746988,0,0,NA,NA,none,hothiphop.parents,hot.parents
2019,1,WCR2019_1080,1,WCR2019_0223,WCR2019_0087,within-group subordinate,within-group subordinate,56,21,35,22,43,43,64,1,99999,485,621,353,0.376179245283019,0,0,NA,NA,none,hothiphop.parents,hot.parents
2019,1,WCR2019_1080,2,WCR2019_0223,WCR2019_0073,within-group subordinate,within-group subordinate,63,25,38,22,53,47,78,1,99999,485,778,435,0.376179245283019,0,0,NA,NA,none,hothiphop.parents,hot.parents
2019,1,WCR2019_1080,3,WCR2019_0440,WCR2019_0087,within-group subordinate,within-group subordinate,66,21,45,32,43,53,64,1,99999,562,621,412,0.376179245283019,0,0,NA,NA,none,hothiphop.parents,hot.parents
2019,1,WCR2019_1081,1,WCR2019_0223,WCR2019_0061,within-group subordinate,within-group subordinate,66,27,39,31,44,58,71,1,99999,485,755,422,0.352872215709261,0,0,NA,NA,none,hothiphop.parents,hot.parents
2019,1,WCR2019_1081,2,WCR2019_0223,WCR2019_0087,within-group subordinate,within-group subordinate,66,26,40,31,42,57,68,1,99999,485,623,355,0.352872215709261,0,0,NA,NA,none,hothiphop.parents,hot.parents
2019,1,WCR2019_1081,3,WCR2019_0223,WCR2019_0327,within-group subordinate,within-group subordinate,69,32,37,31,27,63,59,1,99999,485,822,470,0.352872215709261,0,0,NA,NA,none,hothiphop.parents,hot.parents
2019,1,WCR2019_1082,1,WCR2019_0223,WCR2019_0061,within-group subordinate,within-group subordinate,50,27,23,17,27,44,54,1,99999,487,758,424,0.434579439252336,0,0,NA,NA,none,hothiphop.parents,hot.parents
2019,1,WCR2019_1082,2,WCR2019_0440,WCR2019_0122,within-group subordinate,within-group subordinate,52,27,25,21,12,48,39,1,99999,567,845,561,0.434579439252336,0,0,NA,NA,none,hothiphop.parents,hot.parents
2019,1,WCR2019_1082,3,WCR2019_0223,WCR2019_0161,within-group subordinate,within-group subordinate,53,31,22,17,19,48,50,1,99999,487,806,468,0.434579439252336,0,0,NA,NA,none,hothiphop.parents,hot.parents
2019,1,WCR2019_1083,1,WCR2019_0223,WCR2019_0088,within-group subordinate,within-group subordinate,50,24,26,23,25,47,49,1,99999,484,641,376,0.388304093567251,0,0,NA,NA,none,hothiphop.parents,hot.parents
2019,1,WCR2019_1083,2,WCR2019_0223,WCR2019_0327,within-group subordinate,within-group subordinate,54,24,30,23,19,47,43,1,99999,484,824,469,0.388304093567251,0,0,NA,NA,none,hothiphop.parents,hot.parents
2019,1,WCR2019_1083,3,WCR2019_0223,WCR2019_0061,within-group subordinate,within-group subordinate,62,26,36,23,39,49,65,1,99999,484,757,421,0.388304093567251,0,0,NA,NA,none,hothiphop.parents,hot.parents
2019,1,WCR2019_1084,1,WCR2019_0223,WCR2019_0088,within-group subordinate,within-group subordinate,31,24,7,10,1,34,25,1,99999,486,643,378,0.487747957992999,0,0,NA,NA,none,hothiphop.parents,hot.parents
2019,1,WCR2019_1084,2,WCR2019_0223,WCR2019_0327,within-group subordinate,within-group subordinate,35,22,13,10,3,32,25,1,99999,486,826,471,0.487747957992999,0,0,NA,NA,none,hothiphop.parents,hot.parents
2019,1,WCR2019_1084,3,WCR2019_0223,WCR2019_0075,within-group subordinate,within-group subordinate,38,29,9,10,1,39,30,1,99999,486,747,416,0.487747957992999,0,0,NA,NA,none,hothiphop.parents,hot.parents
2019,1,WCR2019_1085,1,WCR2019_0223,WCR2019_0327,within-group subordinate,within-group subordinate,61,28,33,28,23,56,51,1,99999,484,824,470,0.364168618266979,0,0,NA,NA,none,hothiphop.parents,hot.parents
2019,1,WCR2019_1085,2,WCR2019_0532,WCR2019_0327,within-group subordinate,within-group subordinate,62,39,23,0,23,39,62,1,99999,844,824,814,0.364168618266979,0,0,NA,NA,none,hothiphop.parents,hot.parents
2019,1,WCR2019_1085,3,WCR2019_0223,WCR2019_0087,within-group subordinate,within-group subordinate,62,25,37,28,42,53,67,1,99999,484,621,351,0.364168618266979,0,0,NA,NA,none,hothiphop.parents,hot.parents
2019,1,WCR2019_1087,1,WCR2019_0420,WCR2019_0405,within-group subordinate,within-group subordinate,1,0,1,0,1,0,1,1,99999,858,809,808,0.0442374854481956,0,0,NA,NA,none,hothiphop.parents,hot.parents
2019,1,WCR2019_1087,2,WCR2019_0474,WCR2019_0405,within-group subordinate,within-group subordinate,4,1,3,3,1,4,2,1,99999,737,809,694,0.0442374854481956,0,0,NA,NA,none,hothiphop.parents,hot.parents
2019,1,WCR2019_1087,3,WCR2019_0420,WCR2019_0518,within-group subordinate,within-group subordinate,4,1,3,0,3,1,4,1,99999,858,848,847,0.0442374854481956,0,0,NA,NA,none,hothiphop.parents,hot.parents
2019,1,WCR2019_1088,1,WCR2019_0223,WCR2019_0161,within-group subordinate,within-group subordinate,52,24,28,24,24,48,48,1,99999,487,807,468,0.406067677946324,0,0,NA,NA,none,hothiphop.parents,hot.parents
2019,1,WCR2019_1088,2,WCR2019_0223,WCR2019_0327,within-group subordinate,within-group subordinate,56,25,31,24,16,49,41,1,99999,487,826,472,0.406067677946324,0,0,NA,NA,none,hothiphop.parents,hot.parents
2019,1,WCR2019_1088,3,WCR2019_0223,WCR2019_0088,within-group subordinate,within-group subordinate,56,24,32,24,28,48,52,1,99999,487,643,379,0.406067677946324,0,0,NA,NA,none,hothiphop.parents,hot.parents
2019,1,WCR2019_1091,1,WCR2019_0223,WCR2019_0150,within-group subordinate,within-group subordinate,66,34,32,32,0,66,34,1,99999,476,839,476,0.390941597139452,0,0,NA,NA,none,hothiphop.parents,hot.parents
2019,1,WCR2019_1091,2,WCR2019_0440,WCR2019_0150,within-group subordinate,within-group subordinate,67,36,31,31,0,67,36,1,99999,554,839,554,0.390941597139452,0,0,NA,NA,none,hothiphop.parents,hot.parents
2019,1,WCR2019_1091,3,WCR2019_0223,WCR2019_0075,within-group subordinate,within-group subordinate,70,36,34,32,38,68,74,1,99999,476,733,408,0.390941597139452,0,0,NA,NA,none,hothiphop.parents,hot.parents
2019,1,WCR2019_1092,1,WCR2019_0223,WCR2019_0313,within-group subordinate,within-group subordinate,41,19,22,22,1,41,20,1,99999,488,848,485,0.367869615832363,0,0,NA,NA,none,hothiphop.parents,hot.parents
2019,1,WCR2019_1092,2,WCR2019_0440,WCR2019_0313,within-group subordinate,within-group subordinate,47,24,23,23,1,47,25,1,99999,568,848,560,0.367869615832363,0,0,NA,NA,none,hothiphop.parents,hot.parents
2019,1,WCR2019_1092,3,WCR2019_0440,WCR2019_0122,within-group subordinate,within-group subordinate,47,20,27,23,8,43,28,1,99999,568,847,562,0.367869615832363,0,0,NA,NA,none,hothiphop.parents,hot.parents
2019,1,WCR2019_1093,1,WCR2019_0223,WCR2019_0327,within-group subordinate,within-group subordinate,66,25,41,33,30,58,55,1,99999,482,820,467,0.352526439482961,0,0,NA,NA,none,hothiphop.parents,hot.parents
2019,1,WCR2019_1093,2,WCR2019_0223,WCR2019_0087,within-group subordinate,within-group subordinate,67,20,47,33,42,53,62,1,99999,482,623,353,0.352526439482961,0,0,NA,NA,none,hothiphop.parents,hot.parents
2019,1,WCR2019_1093,3,WCR2019_0223,WCR2019_0075,within-group subordinate,within-group subordinate,68,29,39,33,46,62,75,1,99999,482,743,414,0.352526439482961,0,0,NA,NA,none,hothiphop.parents,hot.parents
2019,1,WCR2019_1094,1,WCR2019_0440,WCR2019_0327,within-group subordinate,within-group subordinate,64,29,35,25,32,54,61,1,99999,564,823,544,0.366510538641686,0,0,NA,NA,none,hothiphop.parents,hot.parents
2019,1,WCR2019_1094,2,WCR2019_0223,WCR2019_0039,within-group subordinate,within-group subordinate,66,30,36,28,42,58,72,1,99999,484,832,472,0.366510538641686,0,0,NA,NA,none,hothiphop.parents,hot.parents
2019,1,WCR2019_1094,3,WCR2019_0223,WCR2019_0061,within-group subordinate,within-group subordinate,68,30,38,28,46,58,76,1,99999,484,756,421,0.366510538641686,0,0,NA,NA,none,hothiphop.parents,hot.parents
2019,1,WCR2019_1095,1,WCR2019_0252,WCR2019_0405,within-group subordinate,within-group subordinate,3,2,1,1,0,3,2,1,99999,817,773,770,0.0658536585365854,0,0,NA,NA,none,hothiphop.parents,hot.parents
2019,1,WCR2019_1095,2,WCR2019_0474,WCR2019_0405,within-group subordinate,within-group subordinate,4,2,2,2,0,4,2,1,99999,702,773,661,0.0658536585365854,0,0,NA,NA,none,hothiphop.parents,hot.parents
2019,1,WCR2019_1095,3,WCR2019_0326,WCR2019_0518,within-group subordinate,within-group subordinate,4,1,3,1,2,2,3,1,99999,820,809,809,0.0658536585365854,0,0,NA,NA,none,hothiphop.parents,hot.parents
2019,1,WCR2019_1097,1,WCR2019_0223,WCR2019_0073,within-group subordinate,within-group subordinate,56,19,37,25,52,44,71,1,99999,481,781,434,0.378091872791519,0,0,NA,NA,none,hothiphop.parents,hot.parents
2019,1,WCR2019_1097,2,WCR2019_0223,WCR2019_0087,within-group subordinate,within-group subordinate,57,22,35,25,38,47,60,1,99999,481,622,352,0.378091872791519,0,0,NA,NA,none,hothiphop.parents,hot.parents
2019,1,WCR2019_1097,3,WCR2019_0223,WCR2019_0327,within-group subordinate,within-group subordinate,58,27,31,25,26,52,53,1,99999,481,818,466,0.378091872791519,0,0,NA,NA,none,hothiphop.parents,hot.parents
2019,1,WCR2019_1098,1,WCR2019_0440,WCR2019_0087,within-group subordinate,within-group subordinate,52,21,31,16,35,37,56,1,99999,505,582,384,0.406332453825858,0,0,NA,NA,none,hothiphop.parents,hot.parents
2019,1,WCR2019_1098,2,WCR2019_0223,WCR2019_0327,within-group subordinate,within-group subordinate,55,29,26,22,16,51,45,1,99999,429,730,417,0.406332453825858,0,0,NA,NA,none,hothiphop.parents,hot.parents
2019,1,WCR2019_1098,3,WCR2019_0440,WCR2019_0327,within-group subordinate,within-group subordinate,58,37,21,16,16,53,53,1,99999,505,730,488,0.406332453825858,0,0,NA,NA,none,hothiphop.parents,hot.parents
2019,1,WCR2019_1099,1,WCR2019_0119,WCR2019_0405,within-group subordinate,within-group subordinate,4,2,2,4,0,6,2,1,99999,855,806,806,0.0572429906542056,0,0,NA,NA,none,hothiphop.parents,hot.parents
2019,1,WCR2019_1099,2,WCR2019_0252,WCR2019_0405,within-group subordinate,within-group subordinate,4,1,3,3,0,4,1,1,99999,853,806,803,0.0572429906542056,0,0,NA,NA,none,hothiphop.parents,hot.parents
2019,1,WCR2019_1099,3,WCR2019_0334,WCR2019_0405,within-group subordinate,within-group subordinate,5,4,1,1,0,5,4,1,99999,853,806,803,0.0572429906542056,0,0,NA,NA,none,hothiphop.parents,hot.parents
2019,1,WCR2019_1100,1,WCR2019_0223,WCR2019_0122,within-group subordinate,within-group subordinate,35,21,14,12,3,33,24,1,99999,486,842,479,0.453161592505855,0,0,NA,NA,none,hothiphop.parents,hot.parents
2019,1,WCR2019_1100,2,WCR2019_0473,WCR2019_0088,within-group subordinate,within-group subordinate,37,26,11,15,1,41,27,1,99999,850,643,641,0.453161592505855,0,0,NA,NA,none,hothiphop.parents,hot.parents
2019,1,WCR2019_1100,3,WCR2019_0223,WCR2019_0088,within-group subordinate,within-group subordinate,38,27,11,12,1,39,28,1,99999,486,643,378,0.453161592505855,0,0,NA,NA,none,hothiphop.parents,hot.parents
2019,1,WCR2019_1101,1,WCR2019_0223,WCR2019_0088,within-group subordinate,within-group subordinate,50,28,22,24,24,52,52,1,99999,489,645,381,0.409090909090909,0,0,NA,NA,none,hothiphop.parents,hot.parents
2019,1,WCR2019_1101,2,WCR2019_0191,WCR2019_0088,within-group subordinate,within-group subordinate,62,38,24,24,24,62,62,1,99999,649,645,475,0.409090909090909,0,0,NA,NA,none,hothiphop.parents,hot.parents
2019,1,WCR2019_1101,3,WCR2019_0440,WCR2019_0122,within-group subordinate,within-group subordinate,62,25,37,25,23,50,48,1,99999,567,846,561,0.409090909090909,0,0,NA,NA,none,hothiphop.parents,hot.parents
2019,1,WCR2019_1102,1,WCR2019_0334,WCR2019_0405,within-group subordinate,within-group subordinate,4,3,1,1,0,4,3,1,99999,831,786,783,0.052757793764988,0,0,NA,NA,none,hothiphop.parents,hot.parents
2019,1,WCR2019_1102,2,WCR2019_0489,WCR2019_0405,within-group subordinate,within-group subordinate,4,3,1,1,0,4,3,1,99999,833,786,785,0.052757793764988,0,0,NA,NA,none,hothiphop.parents,hot.parents
2019,1,WCR2019_1102,3,WCR2019_0252,WCR2019_0405,within-group subordinate,within-group subordinate,5,1,4,4,0,5,1,1,99999,831,786,783,0.052757793764988,0,0,NA,NA,none,hothiphop.parents,hot.parents
2019,1,WCR2019_1104,1,WCR2019_0421,WCR2019_0388,within-group subordinate,within-group subordinate,1,0,1,0,1,0,1,1,99999,857,857,856,0.344988344988345,0,0,NA,NA,none,hothiphop.parents,hot.parents
2019,1,WCR2019_1104,2,WCR2019_0421,WCR2019_0088,within-group subordinate,within-group subordinate,6,5,1,0,1,5,6,1,99999,857,644,643,0.344988344988345,0,0,NA,NA,none,hothiphop.parents,hot.parents
2019,1,WCR2019_1104,3,WCR2019_0421,WCR2019_0518,within-group subordinate,within-group subordinate,9,7,2,0,2,7,9,1,99999,857,847,846,0.344988344988345,0,0,NA,NA,none,hothiphop.parents,hot.parents
2019,1,WCR2019_1105,1,WCR2019_0223,WCR2019_0216,within-group subordinate,within-group subordinate,50,21,29,27,3,48,24,1,99999,483,847,482,0.383352872215709,0,0,NA,NA,none,hothiphop.parents,hot.parents
2019,1,WCR2019_1105,2,WCR2019_0223,WCR2019_0327,within-group subordinate,within-group subordinate,53,19,34,27,27,46,46,1,99999,483,825,471,0.383352872215709,0,0,NA,NA,none,hothiphop.parents,hot.parents
2019,1,WCR2019_1105,3,WCR2019_0440,WCR2019_0216,within-group subordinate,within-group subordinate,56,31,25,23,3,54,34,1,99999,563,847,560,0.383352872215709,0,0,NA,NA,none,hothiphop.parents,hot.parents
2019,1,WCR2019_1106,1,WCR2019_0223,WCR2019_0088,within-group subordinate,within-group subordinate,42,21,21,17,10,38,31,1,99999,489,646,381,0.458139534883721,0,0,NA,NA,none,hothiphop.parents,hot.parents
2019,1,WCR2019_1106,2,WCR2019_0440,WCR2019_0122,within-group subordinate,within-group subordinate,45,22,23,22,11,44,33,1,99999,569,848,563,0.458139534883721,0,0,NA,NA,none,hothiphop.parents,hot.parents
2019,1,WCR2019_1106,3,WCR2019_0223,WCR2019_0161,within-group subordinate,within-group subordinate,46,29,17,17,8,46,37,1,99999,489,810,470,0.458139534883721,0,0,NA,NA,none,hothiphop.parents,hot.parents
2019,1,WCR2019_1107,1,WCR2019_0223,WCR2019_0327,within-group subordinate,within-group subordinate,48,22,26,21,17,43,39,1,99999,488,826,473,0.417736289381564,0,0,NA,NA,none,hothiphop.parents,hot.parents
2019,1,WCR2019_1107,2,WCR2019_0223,WCR2019_0061,within-group subordinate,within-group subordinate,50,23,27,21,33,44,56,1,99999,488,759,425,0.417736289381564,0,0,NA,NA,none,hothiphop.parents,hot.parents
2019,1,WCR2019_1107,3,WCR2019_0223,WCR2019_0088,within-group subordinate,within-group subordinate,56,27,29,21,32,48,59,1,99999,488,643,380,0.417736289381564,0,0,NA,NA,none,hothiphop.parents,hot.parents
2019,1,WCR2019_1108,1,WCR2019_0440,WCR2019_0122,within-group subordinate,within-group subordinate,56,26,30,19,20,45,46,1,99999,568,848,563,0.40162980209546,0,0,NA,NA,none,hothiphop.parents,hot.parents
2019,1,WCR2019_1108,2,WCR2019_0223,WCR2019_0088,within-group subordinate,within-group subordinate,56,25,31,30,25,55,50,1,99999,488,646,381,0.40162980209546,0,0,NA,NA,none,hothiphop.parents,hot.parents
2019,1,WCR2019_1108,3,WCR2019_0223,WCR2019_0075,within-group subordinate,within-group subordinate,59,28,31,30,22,58,50,1,99999,488,749,418,0.40162980209546,0,0,NA,NA,none,hothiphop.parents,hot.parents
2019,1,WCR2019_1109,1,WCR2019_0579,WCR2019_0405,within-group subordinate,within-group subordinate,3,1,2,2,0,3,1,1,99999,834,790,784,0.0607142857142857,0,0,NA,NA,none,hothiphop.parents,hot.parents
2019,1,WCR2019_1109,2,WCR2019_0334,WCR2019_0405,within-group subordinate,within-group subordinate,5,3,2,2,0,5,3,1,99999,837,790,787,0.0607142857142857,0,0,NA,NA,none,hothiphop.parents,hot.parents
2019,1,WCR2019_1109,3,WCR2019_0024,WCR2019_0405,within-group subordinate,within-group subordinate,5,2,3,4,0,6,2,1,99999,839,790,789,0.0607142857142857,0,0,NA,NA,none,hothiphop.parents,hot.parents
2019,1,WCR2019_1110,1,WCR2019_0536,WCR2019_0463,within-group subordinate,within-group subordinate,2,1,1,0,1,1,2,1,99999,839,856,839,0.401869158878505,0,0,NA,NA,none,hothiphop.parents,hot.parents
2019,1,WCR2019_1110,2,WCR2019_0223,WCR2019_0463,within-group subordinate,within-group subordinate,53,37,16,15,1,52,38,1,99999,487,856,487,0.401869158878505,0,0,NA,NA,none,hothiphop.parents,hot.parents
2019,1,WCR2019_1110,3,WCR2019_0440,WCR2019_0463,within-group subordinate,within-group subordinate,55,32,23,23,1,55,33,1,99999,568,856,568,0.401869158878505,0,0,NA,NA,none,hothiphop.parents,hot.parents
2019,1,WCR2019_1111,1,WCR2019_0420,WCR2019_0325,within-group subordinate,within-group subordinate,2,2,0,0,0,2,2,1,99999,852,844,843,0.110199296600234,0,0,NA,NA,none,hothiphop.parents,hot.parents
2019,1,WCR2019_1111,2,WCR2019_0474,WCR2019_0325,within-group subordinate,within-group subordinate,3,1,2,2,0,3,1,1,99999,732,844,725,0.110199296600234,0,0,NA,NA,none,hothiphop.parents,hot.parents
2019,1,WCR2019_1111,3,WCR2019_0420,WCR2019_0592,within-group subordinate,within-group subordinate,4,0,4,0,4,0,4,1,99999,852,850,849,0.110199296600234,0,0,NA,NA,none,hothiphop.parents,hot.parents
2019,1,WCR2019_1115,1,WCR2019_0223,WCR2019_0087,within-group subordinate,within-group subordinate,52,24,28,23,33,47,57,1,99999,485,624,354,0.374707259953162,0,0,NA,NA,none,hothiphop.parents,hot.parents
2019,1,WCR2019_1115,2,WCR2019_0223,WCR2019_0061,within-group subordinate,within-group subordinate,58,27,31,23,41,50,68,1,99999,485,758,423,0.374707259953162,0,0,NA,NA,none,hothiphop.parents,hot.parents
2019,1,WCR2019_1115,3,WCR2019_0440,WCR2019_0087,within-group subordinate,within-group subordinate,60,28,32,22,33,50,61,1,99999,566,624,413,0.374707259953162,0,0,NA,NA,none,hothiphop.parents,hot.parents
2019,1,WCR2019_1117,1,WCR2019_0223,WCR2019_0061,within-group subordinate,within-group subordinate,53,37,16,14,19,51,56,1,99999,474,735,412,0.53855421686747,0,0,NA,NA,none,hothiphop.parents,hot.parents
2019,1,WCR2019_1117,2,WCR2019_0223,WCR2019_0087,within-group subordinate,within-group subordinate,53,33,20,14,23,47,56,1,99999,474,613,349,0.53855421686747,0,0,NA,NA,none,hothiphop.parents,hot.parents
2019,1,WCR2019_1117,3,WCR2019_0223,WCR2019_0088,within-group subordinate,within-group subordinate,59,37,22,14,21,51,58,1,99999,474,626,370,0.53855421686747,0,0,NA,NA,none,hothiphop.parents,hot.parents
2019,1,WCR2019_1118,1,WCR2019_0440,WCR2019_0122,within-group subordinate,within-group subordinate,48,17,31,23,18,40,35,1,99999,567,844,561,0.40303738317757,0,0,NA,NA,none,hothiphop.parents,hot.parents
2019,1,WCR2019_1118,2,WCR2019_0223,WCR2019_0327,within-group subordinate,within-group subordinate,53,23,30,24,19,47,42,1,99999,486,825,471,0.40303738317757,0,0,NA,NA,none,hothiphop.parents,hot.parents
2019,1,WCR2019_1118,3,WCR2019_0223,WCR2019_0088,within-group subordinate,within-group subordinate,54,25,29,24,32,49,57,1,99999,486,643,378,0.40303738317757,0,0,NA,NA,none,hothiphop.parents,hot.parents
2019,1,WCR2019_1119,1,WCR2019_0532,WCR2019_0327,within-group subordinate,within-group subordinate,54,38,16,2,17,40,55,1,99999,836,816,805,0.388429752066116,0,0,NA,NA,none,hothiphop.parents,hot.parents
2019,1,WCR2019_1119,2,WCR2019_0223,WCR2019_0327,within-group subordinate,within-group subordinate,61,33,28,24,17,57,50,1,99999,482,816,467,0.388429752066116,0,0,NA,NA,none,hothiphop.parents,hot.parents
2019,1,WCR2019_1119,3,WCR2019_0440,WCR2019_0122,within-group subordinate,within-group subordinate,62,25,37,23,34,48,59,1,99999,559,835,553,0.388429752066116,0,0,NA,NA,none,hothiphop.parents,hot.parents
2019,1,WCR2019_1120,1,WCR2019_0223,WCR2019_0088,within-group subordinate,within-group subordinate,59,30,29,27,35,57,65,1,99999,483,642,377,0.420681551116334,0,0,NA,NA,none,hothiphop.parents,hot.parents
2019,1,WCR2019_1120,2,WCR2019_0223,WCR2019_0327,within-group subordinate,within-group subordinate,61,31,30,27,20,58,51,1,99999,483,820,468,0.420681551116334,0,0,NA,NA,none,hothiphop.parents,hot.parents
2019,1,WCR2019_1120,3,WCR2019_0223,WCR2019_0087,within-group subordinate,within-group subordinate,62,24,38,27,44,51,68,1,99999,483,623,353,0.420681551116334,0,0,NA,NA,none,hothiphop.parents,hot.parents
2019,1,WCR2019_1122,1,WCR2019_0536,WCR2019_0463,within-group subordinate,within-group subordinate,1,0,1,1,0,1,0,1,99999,827,841,827,0.407847800237812,0,0,NA,NA,none,hothiphop.parents,hot.parents
2019,1,WCR2019_1122,2,WCR2019_0223,WCR2019_0327,within-group subordinate,within-group subordinate,52,22,30,23,22,45,44,1,99999,483,813,468,0.407847800237812,0,0,NA,NA,none,hothiphop.parents,hot.parents
2019,1,WCR2019_1122,3,WCR2019_0223,WCR2019_0463,within-group subordinate,within-group subordinate,53,30,23,23,0,53,30,1,99999,483,841,483,0.407847800237812,0,0,NA,NA,none,hothiphop.parents,hot.parents
2019,1,WCR2019_1123,1,WCR2019_0223,WCR2019_0087,within-group subordinate,within-group subordinate,69,18,51,35,52,53,70,1,99999,486,621,353,0.332552693208431,0,0,NA,NA,none,hothiphop.parents,hot.parents
2019,1,WCR2019_1123,2,WCR2019_0585,WCR2019_0122,within-group subordinate,within-group subordinate,70,34,36,4,33,38,67,1,99999,854,843,843,0.332552693208431,0,0,NA,NA,none,hothiphop.parents,hot.parents
2019,1,WCR2019_1123,3,WCR2019_0585,WCR2019_0327,within-group subordinate,within-group subordinate,72,39,33,4,32,43,71,1,99999,854,823,823,0.332552693208431,0,0,NA,NA,none,hothiphop.parents,hot.parents
2019,1,WCR2019_1124,1,WCR2019_0223,WCR2019_0087,within-group subordinate,within-group subordinate,68,17,51,38,51,55,68,1,99999,487,622,354,0.355555555555556,0,0,NA,NA,none,hothiphop.parents,hot.parents
2019,1,WCR2019_1124,2,WCR2019_0223,WCR2019_0073,within-group subordinate,within-group subordinate,70,15,55,38,65,53,80,1,99999,487,783,436,0.355555555555556,0,0,NA,NA,none,hothiphop.parents,hot.parents
2019,1,WCR2019_1124,3,WCR2019_0223,WCR2019_0075,within-group subordinate,within-group subordinate,74,27,47,38,62,65,89,1,99999,487,746,417,0.355555555555556,0,0,NA,NA,none,hothiphop.parents,hot.parents
2019,1,WCR2019_1125,1,WCR2019_0223,WCR2019_0327,within-group subordinate,within-group subordinate,52,26,26,23,15,49,41,1,99999,487,824,472,0.459649122807018,0,0,NA,NA,none,hothiphop.parents,hot.parents
2019,1,WCR2019_1125,2,WCR2019_0223,WCR2019_0061,within-group subordinate,within-group subordinate,56,30,26,23,23,53,53,1,99999,487,757,424,0.459649122807018,0,0,NA,NA,none,hothiphop.parents,hot.parents
2019,1,WCR2019_1125,3,WCR2019_0223,WCR2019_0258,within-group subordinate,within-group subordinate,57,36,21,23,2,59,38,1,99999,487,840,483,0.459649122807018,0,0,NA,NA,none,hothiphop.parents,hot.parents
2019,1,WCR2019_1126,1,WCR2019_0223,WCR2019_0061,within-group subordinate,within-group subordinate,67,29,38,31,41,60,70,1,99999,488,761,426,0.356643356643357,0,0,NA,NA,none,hothiphop.parents,hot.parents
2019,1,WCR2019_1126,2,WCR2019_0223,WCR2019_0087,within-group subordinate,within-group subordinate,70,24,46,31,52,55,76,1,99999,488,626,356,0.356643356643357,0,0,NA,NA,none,hothiphop.parents,hot.parents
2019,1,WCR2019_1126,3,WCR2019_0223,WCR2019_0073,within-group subordinate,within-group subordinate,73,31,42,31,53,62,84,1,99999,488,786,437,0.356643356643357,0,0,NA,NA,none,hothiphop.parents,hot.parents
2019,1,WCR2019_1127,1,WCR2019_0256,WCR2019_0088,within-group subordinate,within-group subordinate,25,23,2,3,1,26,24,1,99999,842,639,636,0.194082840236686,0,0,NA,NA,none,hothiphop.parents,hot.parents
2019,1,WCR2019_1127,2,WCR2019_0333,WCR2019_0327,within-group subordinate,within-group subordinate,25,13,12,5,9,18,22,1,99999,836,814,806,0.194082840236686,0,0,NA,NA,none,hothiphop.parents,hot.parents
2019,1,WCR2019_1127,3,WCR2019_0165,WCR2019_0088,within-group subordinate,within-group subordinate,26,24,2,5,1,29,25,1,99999,840,639,637,0.194082840236686,0,0,NA,NA,none,hothiphop.parents,hot.parents
2019,1,WCR2019_1128,1,WCR2019_0594,WCR2019_0206,within-group subordinate,within-group subordinate,6,1,5,0,5,1,6,1,99999,833,825,822,0.555023923444976,0,0,NA,NA,none,hothiphop.parents,hot.parents
2019,1,WCR2019_1128,2,WCR2019_0594,WCR2019_0327,within-group subordinate,within-group subordinate,18,14,4,0,4,14,18,1,99999,833,808,805,0.555023923444976,0,0,NA,NA,none,hothiphop.parents,hot.parents
2019,1,WCR2019_1128,3,WCR2019_0594,WCR2019_0122,within-group subordinate,within-group subordinate,24,18,6,0,6,18,24,1,99999,833,824,821,0.555023923444976,0,0,NA,NA,none,hothiphop.parents,hot.parents
2019,1,WCR2019_1129,1,WCR2019_0223,WCR2019_0327,within-group subordinate,within-group subordinate,48,23,25,22,10,45,33,1,99999,488,828,473,0.39580908032596,0,0,NA,NA,none,hothiphop.parents,hot.parents
2019,1,WCR2019_1129,2,WCR2019_0191,WCR2019_0327,within-group subordinate,within-group subordinate,55,29,26,25,10,54,39,1,99999,651,828,628,0.39580908032596,0,0,NA,NA,none,hothiphop.parents,hot.parents
2019,1,WCR2019_1129,3,WCR2019_0223,WCR2019_0075,within-group subordinate,within-group subordinate,55,27,28,22,25,49,52,1,99999,488,749,418,0.39580908032596,0,0,NA,NA,none,hothiphop.parents,hot.parents
2019,1,WCR2019_1130,1,WCR2019_0223,WCR2019_0088,within-group subordinate,within-group subordinate,40,27,13,16,1,43,28,1,99999,489,644,381,0.486013986013986,0,0,NA,NA,none,hothiphop.parents,hot.parents
2019,1,WCR2019_1130,2,WCR2019_0191,WCR2019_0327,within-group subordinate,within-group subordinate,42,29,13,12,4,41,33,1,99999,650,827,627,0.486013986013986,0,0,NA,NA,none,hothiphop.parents,hot.parents
2019,1,WCR2019_1130,3,WCR2019_0440,WCR2019_0122,within-group subordinate,within-group subordinate,44,30,14,14,1,44,31,1,99999,569,846,563,0.486013986013986,0,0,NA,NA,none,hothiphop.parents,hot.parents
2019,1,WCR2019_1131,1,WCR2019_0223,WCR2019_0327,within-group subordinate,within-group subordinate,60,26,34,27,27,53,53,1,99999,476,816,461,0.377804014167651,0,0,NA,NA,none,hothiphop.parents,hot.parents
2019,1,WCR2019_1131,2,WCR2019_0223,WCR2019_0061,within-group subordinate,within-group subordinate,61,26,35,27,45,53,71,1,99999,476,752,416,0.377804014167651,0,0,NA,NA,none,hothiphop.parents,hot.parents
2019,1,WCR2019_1131,3,WCR2019_0223,WCR2019_0088,within-group subordinate,within-group subordinate,62,23,39,27,41,50,64,1,99999,476,637,372,0.377804014167651,0,0,NA,NA,none,hothiphop.parents,hot.parents
2019,1,WCR2019_1132,1,WCR2019_0223,WCR2019_0088,within-group subordinate,within-group subordinate,44,16,28,22,30,38,46,1,99999,483,636,378,0.332938388625592,0,0,NA,NA,none,hothiphop.parents,hot.parents
2019,1,WCR2019_1132,2,WCR2019_0223,WCR2019_0327,within-group subordinate,within-group subordinate,46,16,30,22,17,38,33,1,99999,483,814,468,0.332938388625592,0,0,NA,NA,none,hothiphop.parents,hot.parents
2019,1,WCR2019_1132,3,WCR2019_0223,WCR2019_0075,within-group subordinate,within-group subordinate,48,21,27,22,24,43,45,1,99999,483,737,415,0.332938388625592,0,0,NA,NA,none,hothiphop.parents,hot.parents
2019,1,WCR2019_1133,1,WCR2019_0223,WCR2019_0087,within-group subordinate,within-group subordinate,62,20,42,30,52,50,72,1,99999,473,615,344,0.311163895486936,0,0,NA,NA,none,hothiphop.parents,hot.parents
2019,1,WCR2019_1133,2,WCR2019_0223,WCR2019_0061,within-group subordinate,within-group subordinate,65,27,38,30,47,57,74,1,99999,473,749,414,0.311163895486936,0,0,NA,NA,none,hothiphop.parents,hot.parents
2019,1,WCR2019_1133,3,WCR2019_0223,WCR2019_0073,within-group subordinate,within-group subordinate,72,25,47,30,57,55,82,1,99999,473,772,424,0.311163895486936,0,0,NA,NA,none,hothiphop.parents,hot.parents
2019,1,WCR2019_1134,1,WCR2019_0223,WCR2019_0087,within-group subordinate,within-group subordinate,58,20,38,27,41,47,61,1,99999,487,623,354,0.369158878504673,0,0,NA,NA,none,hothiphop.parents,hot.parents
2019,1,WCR2019_1134,2,WCR2019_0223,WCR2019_0327,within-group subordinate,within-group subordinate,69,37,32,27,26,64,63,1,99999,487,827,472,0.369158878504673,0,0,NA,NA,none,hothiphop.parents,hot.parents
2019,1,WCR2019_1134,3,WCR2019_0585,WCR2019_0327,within-group subordinate,within-group subordinate,73,47,26,1,26,48,73,1,99999,856,827,827,0.369158878504673,0,0,NA,NA,none,hothiphop.parents,hot.parents
2019,1,WCR2019_1137,1,WCR2019_0223,WCR2019_0122,within-group subordinate,within-group subordinate,45,18,27,25,4,43,22,1,99999,478,826,471,0.303102625298329,0,0,NA,NA,none,hothiphop.parents,hot.parents
2019,1,WCR2019_1137,2,WCR2019_0440,WCR2019_0122,within-group subordinate,within-group subordinate,45,11,34,32,4,43,15,1,99999,557,826,551,0.303102625298329,0,0,NA,NA,none,hothiphop.parents,hot.parents
2019,1,WCR2019_1137,3,WCR2019_0223,WCR2019_0519,within-group subordinate,within-group subordinate,47,18,29,25,7,43,25,1,99999,478,834,477,0.303102625298329,0,0,NA,NA,none,hothiphop.parents,hot.parents
2019,1,WCR2019_1138,1,WCR2019_0421,WCR2019_0258,within-group subordinate,within-group subordinate,2,1,1,0,1,1,2,1,99999,857,843,842,0.375291375291375,0,0,NA,NA,none,hothiphop.parents,hot.parents
2019,1,WCR2019_1138,2,WCR2019_0421,WCR2019_0327,within-group subordinate,within-group subordinate,36,24,12,0,12,24,36,1,99999,857,827,826,0.375291375291375,0,0,NA,NA,none,hothiphop.parents,hot.parents
2019,1,WCR2019_1138,3,WCR2019_0421,WCR2019_0122,within-group subordinate,within-group subordinate,42,33,9,0,9,33,42,1,99999,857,846,845,0.375291375291375,0,0,NA,NA,none,hothiphop.parents,hot.parents
2019,1,WCR2019_1140,1,WCR2019_0223,WCR2019_0087,within-group subordinate,within-group subordinate,64,18,46,34,43,52,61,1,99999,489,625,356,0.36013986013986,0,0,NA,NA,none,hothiphop.parents,hot.parents
2019,1,WCR2019_1140,2,WCR2019_0585,WCR2019_0122,within-group subordinate,within-group subordinate,67,34,33,2,31,36,65,1,99999,858,846,846,0.36013986013986,0,0,NA,NA,none,hothiphop.parents,hot.parents
2019,1,WCR2019_1140,3,WCR2019_0223,WCR2019_0073,within-group subordinate,within-group subordinate,72,21,51,34,58,55,79,1,99999,489,786,438,0.36013986013986,0,0,NA,NA,none,hothiphop.parents,hot.parents
2019,1,WCR2019_1142,1,WCR2019_0223,WCR2019_0087,within-group subordinate,within-group subordinate,54,19,35,24,38,43,57,1,99999,488,624,356,0.387134502923977,0,0,NA,NA,none,hothiphop.parents,hot.parents
2019,1,WCR2019_1142,2,WCR2019_0223,WCR2019_0327,within-group subordinate,within-group subordinate,59,30,29,24,28,54,58,1,99999,488,824,473,0.387134502923977,0,0,NA,NA,none,hothiphop.parents,hot.parents
2019,1,WCR2019_1142,3,WCR2019_0223,WCR2019_0061,within-group subordinate,within-group subordinate,60,30,30,24,33,54,63,1,99999,488,757,425,0.387134502923977,0,0,NA,NA,none,hothiphop.parents,hot.parents
2019,1,WCR2019_1144,1,WCR2019_0223,WCR2019_0047,within-group subordinate,within-group subordinate,40,18,22,22,0,40,18,1,99999,486,853,485,0.352459016393443,0,0,NA,NA,none,hothiphop.parents,hot.parents
2019,1,WCR2019_1144,2,WCR2019_0223,WCR2019_0075,within-group subordinate,within-group subordinate,43,21,22,22,20,43,41,1,99999,486,745,417,0.352459016393443,0,0,NA,NA,none,hothiphop.parents,hot.parents
2019,1,WCR2019_1144,3,WCR2019_0223,WCR2019_0061,within-group subordinate,within-group subordinate,47,23,24,22,17,45,40,1,99999,486,757,423,0.352459016393443,0,0,NA,NA,none,hothiphop.parents,hot.parents
2019,1,WCR2019_1145,1,WCR2019_0223,WCR2019_0088,within-group subordinate,within-group subordinate,52,31,21,17,19,48,50,1,99999,489,646,381,0.450523864959255,0,0,NA,NA,none,hothiphop.parents,hot.parents
2019,1,WCR2019_1145,2,WCR2019_0223,WCR2019_0327,within-group subordinate,within-group subordinate,52,30,22,17,10,47,40,1,99999,489,828,474,0.450523864959255,0,0,NA,NA,none,hothiphop.parents,hot.parents
2019,1,WCR2019_1145,3,WCR2019_0223,WCR2019_0285,within-group subordinate,within-group subordinate,54,37,17,17,1,54,38,1,99999,489,852,488,0.450523864959255,0,0,NA,NA,none,hothiphop.parents,hot.parents
2019,1,WCR2019_1146,1,WCR2019_0524,WCR2019_0451,within-group subordinate,within-group subordinate,3,0,3,1,2,1,2,1,99999,842,850,839,0.407971864009379,0,0,NA,NA,none,hothiphop.parents,hot.parents
2019,1,WCR2019_1146,2,WCR2019_0524,WCR2019_0327,within-group subordinate,within-group subordinate,34,26,8,1,7,27,33,1,99999,842,822,813,0.407971864009379,0,0,NA,NA,none,hothiphop.parents,hot.parents
2019,1,WCR2019_1146,3,WCR2019_0223,WCR2019_0088,within-group subordinate,within-group subordinate,36,21,15,13,17,34,38,1,99999,485,643,379,0.407971864009379,0,0,NA,NA,none,hothiphop.parents,hot.parents
2019,1,WCR2019_1147,1,WCR2019_0223,WCR2019_0327,within-group subordinate,within-group subordinate,50,26,24,21,12,47,38,1,99999,469,798,454,0.454764776839566,0,0,NA,NA,none,hothiphop.parents,hot.parents
2019,1,WCR2019_1147,2,WCR2019_0223,WCR2019_0122,within-group subordinate,within-group subordinate,51,25,26,21,13,46,38,1,99999,469,817,462,0.454764776839566,0,0,NA,NA,none,hothiphop.parents,hot.parents
2019,1,WCR2019_1147,3,WCR2019_0440,WCR2019_0122,within-group subordinate,within-group subordinate,55,26,29,21,13,47,39,1,99999,548,817,542,0.454764776839566,0,0,NA,NA,none,hothiphop.parents,hot.parents
2019,1,WCR2019_1148,1,WCR2019_0223,WCR2019_0327,within-group subordinate,within-group subordinate,63,33,30,27,24,60,57,1,99999,487,826,472,0.428238039673279,0,0,NA,NA,none,hothiphop.parents,hot.parents
2019,1,WCR2019_1148,2,WCR2019_0440,WCR2019_0327,within-group subordinate,within-group subordinate,65,40,25,21,24,61,64,1,99999,567,826,547,0.428238039673279,0,0,NA,NA,none,hothiphop.parents,hot.parents
2019,1,WCR2019_1148,3,WCR2019_0223,WCR2019_0061,within-group subordinate,within-group subordinate,65,32,33,27,32,59,64,1,99999,487,759,424,0.428238039673279,0,0,NA,NA,none,hothiphop.parents,hot.parents
2019,1,WCR2019_1149,1,WCR2019_0373,WCR2019_0327,within-group subordinate,within-group subordinate,55,33,22,12,12,45,45,1,99999,728,736,702,0.436601307189542,0,0,NA,NA,none,hothiphop.parents,hot.parents
2019,1,WCR2019_1149,2,WCR2019_0223,WCR2019_0088,within-group subordinate,within-group subordinate,57,31,26,24,23,55,54,1,99999,435,571,337,0.436601307189542,0,0,NA,NA,none,hothiphop.parents,hot.parents
2019,1,WCR2019_1149,3,WCR2019_0440,WCR2019_0122,within-group subordinate,within-group subordinate,57,28,29,20,18,48,46,1,99999,510,753,504,0.436601307189542,0,0,NA,NA,none,hothiphop.parents,hot.parents
2019,1,WCR2019_1150,1,WCR2019_0223,WCR2019_0161,within-group subordinate,within-group subordinate,59,32,27,23,22,55,54,1,99999,488,801,469,0.401880141010576,0,0,NA,NA,none,hothiphop.parents,hot.parents
2019,1,WCR2019_1150,2,WCR2019_0223,WCR2019_0088,within-group subordinate,within-group subordinate,59,28,31,23,30,51,58,1,99999,488,640,380,0.401880141010576,0,0,NA,NA,none,hothiphop.parents,hot.parents
2019,1,WCR2019_1150,3,WCR2019_0440,WCR2019_0122,within-group subordinate,within-group subordinate,59,23,36,22,29,45,52,1,99999,564,839,558,0.401880141010576,0,0,NA,NA,none,hothiphop.parents,hot.parents
2019,1,WCR2019_1151,1,WCR2019_0223,WCR2019_0359,within-group subordinate,within-group subordinate,45,30,15,16,1,46,31,1,99999,465,750,441,0.414448669201521,0,0,NA,NA,none,hothiphop.parents,hot.parents
2019,1,WCR2019_1151,2,WCR2019_0223,WCR2019_0088,within-group subordinate,within-group subordinate,46,25,21,16,24,41,49,1,99999,465,594,363,0.414448669201521,0,0,NA,NA,none,hothiphop.parents,hot.parents
2019,1,WCR2019_1151,3,WCR2019_0223,WCR2019_0327,within-group subordinate,within-group subordinate,48,29,19,16,13,45,42,1,99999,465,761,450,0.414448669201521,0,0,NA,NA,none,hothiphop.parents,hot.parents
2019,1,WCR2019_1153,1,WCR2019_0223,WCR2019_0150,within-group subordinate,within-group subordinate,61,40,21,21,3,61,43,1,99999,453,773,453,0.434670116429495,0,0,NA,NA,none,hothiphop.parents,hot.parents
2019,1,WCR2019_1153,2,WCR2019_0440,WCR2019_0150,within-group subordinate,within-group subordinate,61,40,21,20,3,60,43,1,99999,520,773,520,0.434670116429495,0,0,NA,NA,none,hothiphop.parents,hot.parents
2019,1,WCR2019_1153,3,WCR2019_0223,WCR2019_0327,within-group subordinate,within-group subordinate,61,35,26,21,19,56,54,1,99999,453,744,438,0.434670116429495,0,0,NA,NA,none,hothiphop.parents,hot.parents
2019,1,WCR2019_1154,1,WCR2019_0223,WCR2019_0088,within-group subordinate,within-group subordinate,47,27,20,14,32,41,59,1,99999,466,616,360,0.413919413919414,0,0,NA,NA,none,hothiphop.parents,hot.parents
2019,1,WCR2019_1154,2,WCR2019_0223,WCR2019_0327,within-group subordinate,within-group subordinate,50,30,20,14,16,44,46,1,99999,466,790,452,0.413919413919414,0,0,NA,NA,none,hothiphop.parents,hot.parents
2019,1,WCR2019_1154,3,WCR2019_0223,WCR2019_0087,within-group subordinate,within-group subordinate,50,18,32,14,39,32,57,1,99999,466,593,338,0.413919413919414,0,0,NA,NA,none,hothiphop.parents,hot.parents
2019,1,WCR2019_1155,1,WCR2019_0223,WCR2019_0087,within-group subordinate,within-group subordinate,54,23,31,23,28,46,51,1,99999,455,579,334,0.399244332493703,0,0,NA,NA,none,hothiphop.parents,hot.parents
2019,1,WCR2019_1155,2,WCR2019_0223,WCR2019_0327,within-group subordinate,within-group subordinate,55,25,30,23,19,48,44,1,99999,455,767,442,0.399244332493703,0,0,NA,NA,none,hothiphop.parents,hot.parents
2019,1,WCR2019_1155,3,WCR2019_0223,WCR2019_0204,within-group subordinate,within-group subordinate,55,22,33,23,25,45,47,1,99999,455,791,452,0.399244332493703,0,0,NA,NA,none,hothiphop.parents,hot.parents
2019,1,WCR2019_1156,1,WCR2019_0223,WCR2019_0088,within-group subordinate,within-group subordinate,41,21,20,10,22,31,43,1,99999,477,627,371,0.401433691756272,0,0,NA,NA,none,hothiphop.parents,hot.parents
2019,1,WCR2019_1156,2,WCR2019_0223,WCR2019_0327,within-group subordinate,within-group subordinate,45,29,16,10,10,39,39,1,99999,477,806,462,0.401433691756272,0,0,NA,NA,none,hothiphop.parents,hot.parents
2019,1,WCR2019_1156,3,WCR2019_0223,WCR2019_0075,within-group subordinate,within-group subordinate,47,30,17,10,23,40,53,1,99999,477,730,409,0.401433691756272,0,0,NA,NA,none,hothiphop.parents,hot.parents
2019,1,WCR2019_1158,1,WCR2019_0223,WCR2019_0088,within-group subordinate,within-group subordinate,36,28,8,11,1,39,29,1,99999,441,574,344,0.536553524804178,0,0,NA,NA,none,hothiphop.parents,hot.parents
2019,1,WCR2019_1158,2,WCR2019_0440,WCR2019_0122,within-group subordinate,within-group subordinate,36,22,14,14,2,36,24,1,99999,515,757,510,0.536553524804178,0,0,NA,NA,none,hothiphop.parents,hot.parents
2019,1,WCR2019_1158,3,WCR2019_0223,WCR2019_0327,within-group subordinate,within-group subordinate,39,26,13,11,2,37,28,1,99999,441,741,430,0.536553524804178,0,0,NA,NA,none,hothiphop.parents,hot.parents
2019,1,WCR2019_1159,1,WCR2019_0420,WCR2019_0325,within-group subordinate,within-group subordinate,2,2,0,0,0,2,2,1,99999,789,783,783,0.164765525982256,0,0,NA,NA,none,hothiphop.parents,hot.parents
2019,1,WCR2019_1159,2,WCR2019_0420,WCR2019_0592,within-group subordinate,within-group subordinate,4,1,3,0,3,1,4,1,99999,789,786,786,0.164765525982256,0,0,NA,NA,none,hothiphop.parents,hot.parents
2019,1,WCR2019_1159,3,WCR2019_0474,WCR2019_0325,within-group subordinate,within-group subordinate,5,3,2,2,0,5,3,1,99999,679,783,675,0.164765525982256,0,0,NA,NA,none,hothiphop.parents,hot.parents
2019,1,WCR2019_1160,1,WCR2019_0191,WCR2019_0327,within-group subordinate,within-group subordinate,36,23,13,11,3,34,26,1,99999,616,779,596,0.455334987593052,0,0,NA,NA,none,hothiphop.parents,hot.parents
2019,1,WCR2019_1160,2,WCR2019_0191,WCR2019_0161,within-group subordinate,within-group subordinate,38,26,12,11,4,37,30,1,99999,616,760,580,0.455334987593052,0,0,NA,NA,none,hothiphop.parents,hot.parents
2019,1,WCR2019_1160,3,WCR2019_0223,WCR2019_0088,within-group subordinate,within-group subordinate,38,24,14,17,2,41,26,1,99999,466,610,364,0.455334987593052,0,0,NA,NA,none,hothiphop.parents,hot.parents
2019,1,WCR2019_1161,1,WCR2019_0223,WCR2019_0087,within-group subordinate,within-group subordinate,45,23,22,16,29,39,52,1,99999,390,469,286,0.406106870229008,0,0,NA,NA,none,hothiphop.parents,hot.parents
2019,1,WCR2019_1161,2,WCR2019_0223,WCR2019_0327,within-group subordinate,within-group subordinate,45,23,22,16,16,39,39,1,99999,390,634,382,0.406106870229008,0,0,NA,NA,none,hothiphop.parents,hot.parents
2019,1,WCR2019_1161,3,WCR2019_0223,WCR2019_0061,within-group subordinate,within-group subordinate,47,28,19,16,18,44,46,1,99999,390,574,339,0.406106870229008,0,0,NA,NA,none,hothiphop.parents,hot.parents
2019,1,WCR2019_1162,1,WCR2019_0223,WCR2019_0088,within-group subordinate,within-group subordinate,35,16,19,23,9,39,25,1,99999,429,551,331,0.357624831309042,0,0,NA,NA,none,hothiphop.parents,hot.parents
2019,1,WCR2019_1162,2,WCR2019_0263,WCR2019_0088,within-group subordinate,within-group subordinate,37,24,13,11,9,35,33,1,99999,734,551,547,0.357624831309042,0,0,NA,NA,none,hothiphop.parents,hot.parents
2019,1,WCR2019_1162,3,WCR2019_0263,WCR2019_0122,within-group subordinate,within-group subordinate,41,28,13,11,4,39,32,1,99999,734,731,724,0.357624831309042,0,0,NA,NA,none,hothiphop.parents,hot.parents
2019,1,WCR2019_1163,1,WCR2019_0579,WCR2019_0518,within-group subordinate,within-group subordinate,5,3,2,0,2,3,5,1,99999,519,517,512,0.0896946564885496,0,0,NA,NA,none,hothiphop.parents,hot.parents
2019,1,WCR2019_1163,2,WCR2019_0403,WCR2019_0388,within-group subordinate,within-group subordinate,5,2,3,2,2,4,4,1,99999,503,523,502,0.0896946564885496,0,0,NA,NA,none,hothiphop.parents,hot.parents
2019,1,WCR2019_1163,3,WCR2019_0334,WCR2019_0039,within-group subordinate,within-group subordinate,5,1,4,1,3,2,4,1,99999,521,507,504,0.0896946564885496,0,0,NA,NA,none,hothiphop.parents,hot.parents
2019,1,WCR2019_1166,1,WCR2019_0223,WCR2019_0088,within-group subordinate,within-group subordinate,52,30,22,18,13,48,43,1,99999,430,554,337,0.472259810554804,0,0,NA,NA,none,hothiphop.parents,hot.parents
2019,1,WCR2019_1166,2,WCR2019_0223,WCR2019_0061,within-group subordinate,within-group subordinate,55,32,23,18,15,50,47,1,99999,430,658,379,0.472259810554804,0,0,NA,NA,none,hothiphop.parents,hot.parents
2019,1,WCR2019_1166,3,WCR2019_0223,WCR2019_0075,within-group subordinate,within-group subordinate,57,35,22,18,19,53,54,1,99999,430,640,365,0.472259810554804,0,0,NA,NA,none,hothiphop.parents,hot.parents
2019,1,WCR2019_1167,1,WCR2019_0223,WCR2019_0087,within-group subordinate,within-group subordinate,62,25,37,25,32,50,57,1,99999,465,606,345,0.401709401709402,0,0,NA,NA,none,hothiphop.parents,hot.parents
2019,1,WCR2019_1167,2,WCR2019_0223,WCR2019_0061,within-group subordinate,within-group subordinate,64,29,35,25,45,54,74,1,99999,465,725,404,0.401709401709402,0,0,NA,NA,none,hothiphop.parents,hot.parents
2019,1,WCR2019_1167,3,WCR2019_0440,WCR2019_0122,within-group subordinate,within-group subordinate,64,25,39,22,35,47,60,1,99999,542,808,536,0.401709401709402,0,0,NA,NA,none,hothiphop.parents,hot.parents
2019,1,WCR2019_1168,1,WCR2019_0223,WCR2019_0088,within-group subordinate,within-group subordinate,31,26,5,7,1,33,27,1,99999,399,538,317,0.588744588744589,0,0,NA,NA,none,hothiphop.parents,hot.parents
2019,1,WCR2019_1168,2,WCR2019_0223,WCR2019_0327,within-group subordinate,within-group subordinate,34,25,9,7,3,32,28,1,99999,399,667,387,0.588744588744589,0,0,NA,NA,none,hothiphop.parents,hot.parents
2019,1,WCR2019_1168,3,WCR2019_0440,WCR2019_0122,within-group subordinate,within-group subordinate,36,27,9,9,1,36,28,1,99999,477,684,473,0.588744588744589,0,0,NA,NA,none,hothiphop.parents,hot.parents
2019,1,WCR2019_1169,1,WCR2019_0223,WCR2019_0161,within-group subordinate,within-group subordinate,60,27,33,23,25,50,52,1,99999,487,806,468,0.40303738317757,0,0,NA,NA,none,hothiphop.parents,hot.parents
2019,1,WCR2019_1169,2,WCR2019_0223,WCR2019_0327,within-group subordinate,within-group subordinate,60,26,34,23,28,49,54,1,99999,487,825,472,0.40303738317757,0,0,NA,NA,none,hothiphop.parents,hot.parents
2019,1,WCR2019_1169,3,WCR2019_0223,WCR2019_0088,within-group subordinate,within-group subordinate,60,21,39,23,43,44,64,1,99999,487,642,379,0.40303738317757,0,0,NA,NA,none,hothiphop.parents,hot.parents
2019,1,WCR2019_1171,1,WCR2019_0420,WCR2019_0325,within-group subordinate,within-group subordinate,0,0,0,0,0,0,0,1,99999,811,804,803,0.137931034482759,0,0,NA,NA,none,hothiphop.parents,hot.parents
2019,1,WCR2019_1171,2,WCR2019_0474,WCR2019_0325,within-group subordinate,within-group subordinate,3,1,2,2,0,3,1,1,99999,702,804,696,0.137931034482759,0,0,NA,NA,none,hothiphop.parents,hot.parents
2019,1,WCR2019_1171,3,WCR2019_0420,WCR2019_0592,within-group subordinate,within-group subordinate,3,0,3,0,3,0,3,1,99999,811,809,808,0.137931034482759,0,0,NA,NA,none,hothiphop.parents,hot.parents
2019,1,WCR2019_1172,1,WCR2019_0223,WCR2019_0087,within-group subordinate,within-group subordinate,63,21,42,33,44,54,65,1,99999,487,623,355,0.395321637426901,0,0,NA,NA,none,hothiphop.parents,hot.parents
2019,1,WCR2019_1172,2,WCR2019_0440,WCR2019_0327,within-group subordinate,within-group subordinate,72,43,29,21,26,64,69,1,99999,565,824,545,0.395321637426901,0,0,NA,NA,none,hothiphop.parents,hot.parents
2019,1,WCR2019_1172,3,WCR2019_0440,WCR2019_0109,within-group subordinate,within-group subordinate,72,39,33,21,39,60,78,1,99999,565,821,544,0.395321637426901,0,0,NA,NA,none,hothiphop.parents,hot.parents
2019,1,WCR2019_1173,1,WCR2019_0223,WCR2019_0087,within-group subordinate,within-group subordinate,52,29,23,19,31,48,60,1,99999,448,555,321,0.44300518134715,0,0,NA,NA,none,hothiphop.parents,hot.parents
2019,1,WCR2019_1173,2,WCR2019_0223,WCR2019_0322,within-group subordinate,within-group subordinate,53,33,20,19,1,52,34,1,99999,448,768,446,0.44300518134715,0,0,NA,NA,none,hothiphop.parents,hot.parents
2019,1,WCR2019_1173,3,WCR2019_0440,WCR2019_0322,within-group subordinate,within-group subordinate,56,35,21,20,1,55,36,1,99999,512,768,510,0.44300518134715,0,0,NA,NA,none,hothiphop.parents,hot.parents
2019,1,WCR2019_1174,1,WCR2019_0119,WCR2019_0405,within-group subordinate,within-group subordinate,3,3,0,0,0,3,3,1,99999,760,714,714,0.0657030223390276,0,0,NA,NA,none,hothiphop.parents,hot.parents
2019,1,WCR2019_1174,2,WCR2019_0334,WCR2019_0405,within-group subordinate,within-group subordinate,3,2,1,1,0,3,2,1,99999,758,714,711,0.0657030223390276,0,0,NA,NA,none,hothiphop.parents,hot.parents
2019,1,WCR2019_1174,3,WCR2019_0326,WCR2019_0518,within-group subordinate,within-group subordinate,3,1,2,2,1,3,2,1,99999,761,753,753,0.0657030223390276,0,0,NA,NA,none,hothiphop.parents,hot.parents
2019,1,WCR2019_1175,1,WCR2019_0223,WCR2019_0087,within-group subordinate,within-group subordinate,54,21,33,31,31,52,52,1,99999,465,586,334,0.403940886699507,0,0,NA,NA,none,hothiphop.parents,hot.parents
2019,1,WCR2019_1175,2,WCR2019_0440,WCR2019_0087,within-group subordinate,within-group subordinate,61,23,38,28,31,51,54,1,99999,540,586,388,0.403940886699507,0,0,NA,NA,none,hothiphop.parents,hot.parents
2019,1,WCR2019_1175,3,WCR2019_0223,WCR2019_0516,within-group subordinate,within-group subordinate,62,31,31,31,0,62,31,1,99999,465,805,464,0.403940886699507,0,0,NA,NA,none,hothiphop.parents,hot.parents
2019,1,WCR2019_1326,1,WCR2019_0223,WCR2019_0087,within-group subordinate,within-group subordinate,35,20,15,13,18,33,38,1,99999,304,399,233,0.530769230769231,0,0,NA,NA,none,hothiphop.parents,hot.parents
2019,1,WCR2019_1326,2,WCR2019_0223,WCR2019_0327,within-group subordinate,within-group subordinate,39,23,16,13,12,36,35,1,99999,304,502,296,0.530769230769231,0,0,NA,NA,none,hothiphop.parents,hot.parents
2019,1,WCR2019_1326,3,WCR2019_0223,WCR2019_0073,within-group subordinate,within-group subordinate,42,20,22,13,25,33,45,1,99999,304,480,277,0.530769230769231,0,0,NA,NA,none,hothiphop.parents,hot.parents
2019,1,WCR2019_1327,1,WCR2019_0223,WCR2019_0088,within-group subordinate,within-group subordinate,26,15,11,8,12,23,27,1,99999,291,373,232,0.650103519668737,0,0,NA,NA,none,hothiphop.parents,hot.parents
2019,1,WCR2019_1327,2,WCR2019_0223,WCR2019_0327,within-group subordinate,within-group subordinate,29,20,9,8,5,28,25,1,99999,291,464,280,0.650103519668737,0,0,NA,NA,none,hothiphop.parents,hot.parents
2019,1,WCR2019_1327,3,WCR2019_0223,WCR2019_0161,within-group subordinate,within-group subordinate,32,23,9,8,7,31,30,1,99999,291,461,280,0.650103519668737,0,0,NA,NA,none,hothiphop.parents,hot.parents
2019,1,WCR2019_1328,1,WCR2019_0223,WCR2019_0327,within-group subordinate,within-group subordinate,47,23,24,21,10,44,33,1,99999,407,685,395,0.442090395480226,0,0,NA,NA,none,hothiphop.parents,hot.parents
2019,1,WCR2019_1328,2,WCR2019_0223,WCR2019_0088,within-group subordinate,within-group subordinate,51,22,29,21,30,43,52,1,99999,407,529,319,0.442090395480226,0,0,NA,NA,none,hothiphop.parents,hot.parents
2019,1,WCR2019_1328,3,WCR2019_0440,WCR2019_0327,within-group subordinate,within-group subordinate,54,38,16,11,10,49,48,1,99999,478,685,463,0.442090395480226,0,0,NA,NA,none,hothiphop.parents,hot.parents
2019,1,WCR2019_1329,1,WCR2019_0223,WCR2019_0087,within-group subordinate,within-group subordinate,50,21,29,25,24,46,45,1,99999,393,488,282,0.472303206997085,0,0,NA,NA,none,hothiphop.parents,hot.parents
2019,1,WCR2019_1329,2,WCR2019_0440,WCR2019_0122,within-group subordinate,within-group subordinate,55,26,29,21,25,47,51,1,99999,458,676,452,0.472303206997085,0,0,NA,NA,none,hothiphop.parents,hot.parents
2019,1,WCR2019_1329,3,WCR2019_0223,WCR2019_0161,within-group subordinate,within-group subordinate,61,35,26,25,17,60,52,1,99999,393,641,375,0.472303206997085,0,0,NA,NA,none,hothiphop.parents,hot.parents
2019,1,WCR2019_1330,1,WCR2019_0223,WCR2019_0088,within-group subordinate,within-group subordinate,37,18,19,20,11,38,29,1,99999,364,469,281,0.439807383627608,0,0,NA,NA,none,hothiphop.parents,hot.parents
2019,1,WCR2019_1330,2,WCR2019_0223,WCR2019_0161,within-group subordinate,within-group subordinate,40,16,24,20,16,36,32,1,99999,364,587,349,0.439807383627608,0,0,NA,NA,none,hothiphop.parents,hot.parents
2019,1,WCR2019_1330,3,WCR2019_0223,WCR2019_0122,within-group subordinate,within-group subordinate,42,19,23,20,9,39,28,1,99999,364,613,357,0.439807383627608,0,0,NA,NA,none,hothiphop.parents,hot.parents
2019,1,WCR2019_1331,1,WCR2019_0223,WCR2019_0087,within-group subordinate,within-group subordinate,52,21,31,24,36,45,57,1,99999,450,572,327,0.391634980988593,0,0,NA,NA,none,hothiphop.parents,hot.parents
2019,1,WCR2019_1331,2,WCR2019_0223,WCR2019_0327,within-group subordinate,within-group subordinate,56,24,32,24,27,48,51,1,99999,450,762,437,0.391634980988593,0,0,NA,NA,none,hothiphop.parents,hot.parents
2019,1,WCR2019_1331,3,WCR2019_0223,WCR2019_0061,within-group subordinate,within-group subordinate,58,31,27,24,38,55,69,1,99999,450,698,391,0.391634980988593,0,0,NA,NA,none,hothiphop.parents,hot.parents
2019,1,WCR2019_1332,1,WCR2019_0223,WCR2019_0088,within-group subordinate,within-group subordinate,39,26,13,15,6,41,32,1,99999,420,538,327,0.560055865921788,0,0,NA,NA,none,hothiphop.parents,hot.parents
2019,1,WCR2019_1332,2,WCR2019_0223,WCR2019_0061,within-group subordinate,within-group subordinate,45,30,15,15,12,45,42,1,99999,420,634,366,0.560055865921788,0,0,NA,NA,none,hothiphop.parents,hot.parents
2019,1,WCR2019_1332,3,WCR2019_0223,WCR2019_0075,within-group subordinate,within-group subordinate,47,36,11,15,7,51,43,1,99999,420,625,358,0.560055865921788,0,0,NA,NA,none,hothiphop.parents,hot.parents
2019,1,WCR2019_1333,1,WCR2019_0223,WCR2019_0088,within-group subordinate,within-group subordinate,46,22,24,20,24,42,46,1,99999,441,573,343,0.471968709256845,0,0,NA,NA,none,hothiphop.parents,hot.parents
2019,1,WCR2019_1333,2,WCR2019_0223,WCR2019_0087,within-group subordinate,within-group subordinate,51,24,27,20,34,44,58,1,99999,441,552,318,0.471968709256845,0,0,NA,NA,none,hothiphop.parents,hot.parents
2019,1,WCR2019_1333,3,WCR2019_0440,WCR2019_0122,within-group subordinate,within-group subordinate,51,21,30,23,11,44,32,1,99999,513,758,508,0.471968709256845,0,0,NA,NA,none,hothiphop.parents,hot.parents
2019,1,WCR2019_1335,1,WCR2019_0223,WCR2019_0088,within-group subordinate,within-group subordinate,44,16,28,25,25,41,41,1,99999,488,643,381,0.405847953216374,0,0,NA,NA,none,hothiphop.parents,hot.parents
2019,1,WCR2019_1335,2,WCR2019_0223,WCR2019_0258,within-group subordinate,within-group subordinate,50,27,23,25,2,52,29,1,99999,488,840,484,0.405847953216374,0,0,NA,NA,none,hothiphop.parents,hot.parents
2019,1,WCR2019_1335,3,WCR2019_0223,WCR2019_0327,within-group subordinate,within-group subordinate,50,24,26,25,11,49,35,1,99999,488,824,473,0.405847953216374,0,0,NA,NA,none,hothiphop.parents,hot.parents
2019,1,WCR2019_1336,1,WCR2019_0440,WCR2019_0122,within-group subordinate,within-group subordinate,52,22,30,22,16,44,38,1,99999,567,844,561,0.399532710280374,0,0,NA,NA,none,hothiphop.parents,hot.parents
2019,1,WCR2019_1336,2,WCR2019_0223,WCR2019_0327,within-group subordinate,within-group subordinate,53,29,24,23,12,52,41,1,99999,487,825,472,0.399532710280374,0,0,NA,NA,none,hothiphop.parents,hot.parents
2019,1,WCR2019_1336,3,WCR2019_0440,WCR2019_0285,within-group subordinate,within-group subordinate,54,32,22,22,2,54,34,1,99999,567,849,564,0.399532710280374,0,0,NA,NA,none,hothiphop.parents,hot.parents
2019,1,WCR2019_1338,1,WCR2019_0223,WCR2019_0088,within-group subordinate,within-group subordinate,52,25,27,19,26,44,51,1,99999,453,593,350,0.455233291298865,0,0,NA,NA,none,hothiphop.parents,hot.parents
2019,1,WCR2019_1338,2,WCR2019_0223,WCR2019_0122,within-group subordinate,within-group subordinate,54,29,25,19,21,48,50,1,99999,453,782,447,0.455233291298865,0,0,NA,NA,none,hothiphop.parents,hot.parents
2019,1,WCR2019_1338,3,WCR2019_0223,WCR2019_0327,within-group subordinate,within-group subordinate,54,29,25,19,21,48,50,1,99999,453,767,439,0.455233291298865,0,0,NA,NA,none,hothiphop.parents,hot.parents
2019,1,WCR2019_1339,1,WCR2019_0420,WCR2019_0325,within-group subordinate,within-group subordinate,0,0,0,0,0,0,0,1,99999,811,803,802,0.105911330049261,0,0,NA,NA,none,hothiphop.parents,hot.parents
2019,1,WCR2019_1339,2,WCR2019_0420,WCR2019_0592,within-group subordinate,within-group subordinate,1,0,1,0,1,0,1,1,99999,811,809,808,0.105911330049261,0,0,NA,NA,none,hothiphop.parents,hot.parents
2019,1,WCR2019_1339,3,WCR2019_0474,WCR2019_0325,within-group subordinate,within-group subordinate,2,0,2,2,0,2,0,1,99999,697,803,690,0.105911330049261,0,0,NA,NA,none,hothiphop.parents,hot.parents
2019,1,WCR2019_1340,1,WCR2019_0536,WCR2019_0463,within-group subordinate,within-group subordinate,2,0,2,1,1,1,1,1,99999,808,825,808,0.416969696969697,0,0,NA,NA,none,hothiphop.parents,hot.parents
2019,1,WCR2019_1340,2,WCR2019_0223,WCR2019_0463,within-group subordinate,within-group subordinate,53,34,19,18,1,52,35,1,99999,468,825,468,0.416969696969697,0,0,NA,NA,none,hothiphop.parents,hot.parents
2019,1,WCR2019_1340,3,WCR2019_0223,WCR2019_0088,within-group subordinate,within-group subordinate,56,29,27,18,34,47,63,1,99999,468,620,364,0.416969696969697,0,0,NA,NA,none,hothiphop.parents,hot.parents
2019,1,WCR2019_1341,1,WCR2019_0223,WCR2019_0088,within-group subordinate,within-group subordinate,53,26,27,19,29,45,55,1,99999,470,620,366,0.420096852300242,0,0,NA,NA,none,hothiphop.parents,hot.parents
2019,1,WCR2019_1341,2,WCR2019_0223,WCR2019_0327,within-group subordinate,within-group subordinate,60,33,27,19,18,52,51,1,99999,470,798,457,0.420096852300242,0,0,NA,NA,none,hothiphop.parents,hot.parents
2019,1,WCR2019_1341,3,WCR2019_0223,WCR2019_0161,within-group subordinate,within-group subordinate,62,38,24,19,25,57,63,1,99999,470,776,451,0.420096852300242,0,0,NA,NA,none,hothiphop.parents,hot.parents
2019,1,WCR2019_1342,1,WCR2019_0223,WCR2019_0087,within-group subordinate,within-group subordinate,56,21,35,21,33,42,54,1,99999,406,523,300,0.422535211267606,0,0,NA,NA,none,hothiphop.parents,hot.parents
2019,1,WCR2019_1342,2,WCR2019_0223,WCR2019_0327,within-group subordinate,within-group subordinate,61,33,28,21,20,54,53,1,99999,406,687,395,0.422535211267606,0,0,NA,NA,none,hothiphop.parents,hot.parents
2019,1,WCR2019_1342,3,WCR2019_0223,WCR2019_0061,within-group subordinate,within-group subordinate,62,22,40,21,40,43,62,1,99999,406,628,353,0.422535211267606,0,0,NA,NA,none,hothiphop.parents,hot.parents
2019,1,WCR2019_1343,1,WCR2019_0223,WCR2019_0087,within-group subordinate,within-group subordinate,24,11,13,10,13,21,24,1,99999,314,390,231,0.518796992481203,0,0,NA,NA,none,hothiphop.parents,hot.parents
2019,1,WCR2019_1343,2,WCR2019_0223,WCR2019_0516,within-group subordinate,within-group subordinate,32,21,11,10,2,31,23,1,99999,314,531,314,0.518796992481203,0,0,NA,NA,none,hothiphop.parents,hot.parents
2019,1,WCR2019_1343,3,WCR2019_0440,WCR2019_0087,within-group subordinate,within-group subordinate,39,23,16,15,13,38,36,1,99999,365,390,267,0.518796992481203,0,0,NA,NA,none,hothiphop.parents,hot.parents
2019,1,WCR2019_1344,1,WCR2019_0223,WCR2019_0087,within-group subordinate,within-group subordinate,42,17,25,20,23,37,40,1,99999,342,430,248,0.494077834179357,0,0,NA,NA,none,hothiphop.parents,hot.parents
2019,1,WCR2019_1344,2,WCR2019_0223,WCR2019_0327,within-group subordinate,within-group subordinate,46,21,25,20,16,41,37,1,99999,342,573,334,0.494077834179357,0,0,NA,NA,none,hothiphop.parents,hot.parents
2019,1,WCR2019_1344,3,WCR2019_0223,WCR2019_0075,within-group subordinate,within-group subordinate,49,27,22,20,21,47,48,1,99999,342,517,291,0.494077834179357,0,0,NA,NA,none,hothiphop.parents,hot.parents
2019,1,WCR2019_1345,1,WCR2019_0474,WCR2019_0516,within-group subordinate,within-group subordinate,8,2,6,4,5,6,7,1,99999,703,813,696,0.440243902439024,0,0,NA,NA,none,hothiphop.parents,hot.parents
2019,1,WCR2019_1345,2,WCR2019_0489,WCR2019_0516,within-group subordinate,within-group subordinate,12,5,7,2,5,7,10,1,99999,819,813,812,0.440243902439024,0,0,NA,NA,none,hothiphop.parents,hot.parents
2019,1,WCR2019_1345,3,WCR2019_0479,WCR2019_0516,within-group subordinate,within-group subordinate,13,8,5,0,5,8,13,1,99999,816,813,809,0.440243902439024,0,0,NA,NA,none,hothiphop.parents,hot.parents
2019,1,WCR2019_1347,1,WCR2019_0223,WCR2019_0088,within-group subordinate,within-group subordinate,34,27,7,10,2,37,29,1,99999,470,606,365,0.482758620689655,0,0,NA,NA,none,hothiphop.parents,hot.parents
2019,1,WCR2019_1347,2,WCR2019_0191,WCR2019_0327,within-group subordinate,within-group subordinate,36,28,8,9,2,37,30,1,99999,625,782,602,0.482758620689655,0,0,NA,NA,none,hothiphop.parents,hot.parents
2019,1,WCR2019_1347,3,WCR2019_0191,WCR2019_0088,within-group subordinate,within-group subordinate,38,30,8,9,2,39,32,1,99999,625,606,455,0.482758620689655,0,0,NA,NA,none,hothiphop.parents,hot.parents
2019,1,WCR2019_1348,1,WCR2019_0420,WCR2019_0325,within-group subordinate,within-group subordinate,1,0,1,1,0,1,0,1,99999,826,818,818,0.147699757869249,0,0,NA,NA,none,hothiphop.parents,hot.parents
2019,1,WCR2019_1348,2,WCR2019_0474,WCR2019_0325,within-group subordinate,within-group subordinate,1,0,1,1,0,1,0,1,99999,713,818,707,0.147699757869249,0,0,NA,NA,none,hothiphop.parents,hot.parents
2019,1,WCR2019_1348,3,WCR2019_0420,WCR2019_0592,within-group subordinate,within-group subordinate,1,0,1,1,0,1,0,1,99999,826,823,823,0.147699757869249,0,0,NA,NA,none,hothiphop.parents,hot.parents
2019,1,WCR2019_1350,1,WCR2019_0223,WCR2019_0075,within-group subordinate,within-group subordinate,54,29,25,23,20,52,49,1,99999,481,736,411,0.411347517730496,0,0,NA,NA,none,hothiphop.parents,hot.parents
2019,1,WCR2019_1350,2,WCR2019_0440,WCR2019_0122,within-group subordinate,within-group subordinate,54,26,28,21,22,47,48,1,99999,561,834,555,0.411347517730496,0,0,NA,NA,none,hothiphop.parents,hot.parents
2019,1,WCR2019_1350,3,WCR2019_0223,WCR2019_0122,within-group subordinate,within-group subordinate,57,25,32,23,22,48,47,1,99999,481,834,474,0.411347517730496,0,0,NA,NA,none,hothiphop.parents,hot.parents
2019,1,WCR2019_1351,1,WCR2019_0479,WCR2019_0405,within-group subordinate,within-group subordinate,5,3,2,2,0,5,3,1,99999,834,787,785,0.0550239234449761,0,0,NA,NA,none,hothiphop.parents,hot.parents
2019,1,WCR2019_1351,2,WCR2019_0252,WCR2019_0405,within-group subordinate,within-group subordinate,5,2,3,3,0,5,2,1,99999,833,787,784,0.0550239234449761,0,0,NA,NA,none,hothiphop.parents,hot.parents
2019,1,WCR2019_1351,3,WCR2019_0474,WCR2019_0405,within-group subordinate,within-group subordinate,5,2,3,4,0,6,2,1,99999,720,787,678,0.0550239234449761,0,0,NA,NA,none,hothiphop.parents,hot.parents
2019,1,WCR2019_1352,1,WCR2019_0440,WCR2019_0122,within-group subordinate,within-group subordinate,46,18,28,18,20,36,38,1,99999,563,837,557,0.401648998822144,0,0,NA,NA,none,hothiphop.parents,hot.parents
2019,1,WCR2019_1352,2,WCR2019_0440,WCR2019_0161,within-group subordinate,within-group subordinate,53,31,22,18,15,49,46,1,99999,563,799,540,0.401648998822144,0,0,NA,NA,none,hothiphop.parents,hot.parents
2019,1,WCR2019_1352,3,WCR2019_0223,WCR2019_0327,within-group subordinate,within-group subordinate,54,28,26,23,16,51,44,1,99999,484,819,470,0.401648998822144,0,0,NA,NA,none,hothiphop.parents,hot.parents
2019,1,WCR2019_1353,1,WCR2019_0223,WCR2019_0088,within-group subordinate,within-group subordinate,41,28,13,14,6,42,34,1,99999,477,626,370,0.51500600240096,0,0,NA,NA,none,hothiphop.parents,hot.parents
2019,1,WCR2019_1353,2,WCR2019_0223,WCR2019_0061,within-group subordinate,within-group subordinate,43,30,13,14,9,44,39,1,99999,477,739,415,0.51500600240096,0,0,NA,NA,none,hothiphop.parents,hot.parents
2019,1,WCR2019_1353,3,WCR2019_0223,WCR2019_0206,within-group subordinate,within-group subordinate,48,33,15,14,4,47,37,1,99999,477,821,474,0.51500600240096,0,0,NA,NA,none,hothiphop.parents,hot.parents
2019,1,WCR2019_1354,1,WCR2019_0223,WCR2019_0088,within-group subordinate,within-group subordinate,52,23,29,22,29,45,52,1,99999,486,639,379,0.36310223266745,0,0,NA,NA,none,hothiphop.parents,hot.parents
2019,1,WCR2019_1354,2,WCR2019_0223,WCR2019_0061,within-group subordinate,within-group subordinate,53,29,24,22,27,51,56,1,99999,486,755,424,0.36310223266745,0,0,NA,NA,none,hothiphop.parents,hot.parents
2019,1,WCR2019_1354,3,WCR2019_0223,WCR2019_0075,within-group subordinate,within-group subordinate,53,27,26,22,28,49,55,1,99999,486,741,416,0.36310223266745,0,0,NA,NA,none,hothiphop.parents,hot.parents
2019,1,WCR2019_1356,1,WCR2019_0534,WCR2019_0066,within-group subordinate,within-group subordinate,25,19,6,6,0,25,19,1,99999,851,850,846,0.409356725146199,0,0,NA,NA,none,hothiphop.parents,hot.parents
2019,1,WCR2019_1356,2,WCR2019_0440,WCR2019_0122,within-group subordinate,within-group subordinate,49,27,22,17,15,44,42,1,99999,565,843,559,0.409356725146199,0,0,NA,NA,none,hothiphop.parents,hot.parents
2019,1,WCR2019_1356,3,WCR2019_0440,WCR2019_0327,within-group subordinate,within-group subordinate,50,31,19,17,11,48,42,1,99999,565,824,545,0.409356725146199,0,0,NA,NA,none,hothiphop.parents,hot.parents
2019,1,WCR2019_1357,1,WCR2019_0223,WCR2019_0061,within-group subordinate,within-group subordinate,55,26,29,27,22,53,48,1,99999,466,718,408,0.415841584158416,0,0,NA,NA,none,hothiphop.parents,hot.parents
2019,1,WCR2019_1357,2,WCR2019_0223,WCR2019_0088,within-group subordinate,within-group subordinate,57,26,31,27,26,53,52,1,99999,466,609,364,0.415841584158416,0,0,NA,NA,none,hothiphop.parents,hot.parents
2019,1,WCR2019_1357,3,WCR2019_0440,WCR2019_0327,within-group subordinate,within-group subordinate,59,33,26,23,17,56,50,1,99999,538,782,522,0.415841584158416,0,0,NA,NA,none,hothiphop.parents,hot.parents
2019,1,WCR2019_1358,1,WCR2019_0427,WCR2019_0327,within-group subordinate,within-group subordinate,34,17,17,1,16,18,33,1,99999,818,790,790,0.422982885085575,0,0,NA,NA,none,hothiphop.parents,hot.parents
2019,1,WCR2019_1358,2,WCR2019_0427,WCR2019_0122,within-group subordinate,within-group subordinate,35,24,11,1,10,25,34,1,99999,818,806,806,0.422982885085575,0,0,NA,NA,none,hothiphop.parents,hot.parents
2019,1,WCR2019_1358,3,WCR2019_0427,WCR2019_0047,within-group subordinate,within-group subordinate,41,27,14,1,14,28,41,1,99999,818,817,817,0.422982885085575,0,0,NA,NA,none,hothiphop.parents,hot.parents
2019,1,WCR2019_1359,1,WCR2019_0440,WCR2019_0122,within-group subordinate,within-group subordinate,71,30,41,26,35,56,65,1,99999,549,816,543,0.347037484885127,0,0,NA,NA,none,hothiphop.parents,hot.parents
2019,1,WCR2019_1359,2,WCR2019_0223,WCR2019_0061,within-group subordinate,within-group subordinate,72,28,44,33,41,61,69,1,99999,473,735,412,0.347037484885127,0,0,NA,NA,none,hothiphop.parents,hot.parents
2019,1,WCR2019_1359,3,WCR2019_0440,WCR2019_0327,within-group subordinate,within-group subordinate,73,37,36,26,27,63,64,1,99999,549,798,530,0.347037484885127,0,0,NA,NA,none,hothiphop.parents,hot.parents
2019,1,WCR2019_1360,1,WCR2019_0440,WCR2019_0122,within-group subordinate,within-group subordinate,22,12,10,7,7,19,19,1,99999,302,428,300,0.604166666666667,0,0,NA,NA,none,hothiphop.parents,hot.parents
2019,1,WCR2019_1360,2,WCR2019_0223,WCR2019_0327,within-group subordinate,within-group subordinate,28,12,16,15,7,27,19,1,99999,255,414,246,0.604166666666667,0,0,NA,NA,none,hothiphop.parents,hot.parents
2019,1,WCR2019_1360,3,WCR2019_0440,WCR2019_0537,within-group subordinate,within-group subordinate,30,22,8,7,5,29,27,1,99999,302,432,302,0.604166666666667,0,0,NA,NA,none,hothiphop.parents,hot.parents
2019,1,WCR2019_1361,1,WCR2019_0223,WCR2019_0061,within-group subordinate,within-group subordinate,54,28,26,20,29,48,57,1,99999,411,626,360,0.431818181818182,0,0,NA,NA,none,hothiphop.parents,hot.parents
2019,1,WCR2019_1361,2,WCR2019_0223,WCR2019_0327,within-group subordinate,within-group subordinate,56,31,25,20,9,51,40,1,99999,411,682,401,0.431818181818182,0,0,NA,NA,none,hothiphop.parents,hot.parents
2019,1,WCR2019_1361,3,WCR2019_0440,WCR2019_0327,within-group subordinate,within-group subordinate,57,39,18,13,9,52,48,1,99999,479,682,464,0.431818181818182,0,0,NA,NA,none,hothiphop.parents,hot.parents
2019,1,WCR2019_1363,1,WCR2019_0223,WCR2019_0088,within-group subordinate,within-group subordinate,37,21,16,12,10,33,31,1,99999,463,596,359,0.46125,0,0,NA,NA,none,hothiphop.parents,hot.parents
2019,1,WCR2019_1363,2,WCR2019_0223,WCR2019_0122,within-group subordinate,within-group subordinate,42,26,16,12,10,38,36,1,99999,463,789,457,0.46125,0,0,NA,NA,none,hothiphop.parents,hot.parents
2019,1,WCR2019_1363,3,WCR2019_0223,WCR2019_0327,within-group subordinate,within-group subordinate,42,26,16,12,10,38,36,1,99999,463,771,449,0.46125,0,0,NA,NA,none,hothiphop.parents,hot.parents
2019,1,WCR2019_1365,1,WCR2019_0223,WCR2019_0088,within-group subordinate,within-group subordinate,36,18,18,21,3,39,21,1,99999,446,577,344,0.377577319587629,0,0,NA,NA,none,hothiphop.parents,hot.parents
2019,1,WCR2019_1365,2,WCR2019_0288,WCR2019_0122,within-group subordinate,within-group subordinate,38,33,5,5,2,38,35,1,99999,773,767,764,0.377577319587629,0,0,NA,NA,none,hothiphop.parents,hot.parents
2019,1,WCR2019_1365,3,WCR2019_0191,WCR2019_0088,within-group subordinate,within-group subordinate,39,23,16,22,3,45,26,1,99999,593,577,431,0.377577319587629,0,0,NA,NA,none,hothiphop.parents,hot.parents
2019,1,WCR2019_1367,1,WCR2019_0223,WCR2019_0087,within-group subordinate,within-group subordinate,66,25,41,29,41,54,66,1,99999,484,616,351,0.384887839433294,0,0,NA,NA,none,hothiphop.parents,hot.parents
2019,1,WCR2019_1367,2,WCR2019_0440,WCR2019_0327,within-group subordinate,within-group subordinate,69,38,31,27,23,65,61,1,99999,560,816,540,0.384887839433294,0,0,NA,NA,none,hothiphop.parents,hot.parents
2019,1,WCR2019_1367,3,WCR2019_0191,WCR2019_0327,within-group subordinate,within-group subordinate,73,43,30,20,23,63,66,1,99999,644,816,621,0.384887839433294,0,0,NA,NA,none,hothiphop.parents,hot.parents
2019,1,WCR2019_1368,1,WCR2019_0223,WCR2019_0087,within-group subordinate,within-group subordinate,61,21,40,28,44,49,65,1,99999,467,584,341,0.363295880149813,0,0,NA,NA,none,hothiphop.parents,hot.parents
2019,1,WCR2019_1368,2,WCR2019_0223,WCR2019_0061,within-group subordinate,within-group subordinate,62,23,39,28,41,51,64,1,99999,467,706,404,0.363295880149813,0,0,NA,NA,none,hothiphop.parents,hot.parents
2019,1,WCR2019_1368,3,WCR2019_0223,WCR2019_0327,within-group subordinate,within-group subordinate,63,27,36,28,27,55,54,1,99999,467,773,453,0.363295880149813,0,0,NA,NA,none,hothiphop.parents,hot.parents
2019,1,WCR2019_1369,1,WCR2019_0223,WCR2019_0327,within-group subordinate,within-group subordinate,53,31,22,21,13,52,44,1,99999,424,710,413,0.41304347826087,0,0,NA,NA,none,hothiphop.parents,hot.parents
2019,1,WCR2019_1369,2,WCR2019_0223,WCR2019_0061,within-group subordinate,within-group subordinate,54,28,26,21,22,49,50,1,99999,424,645,366,0.41304347826087,0,0,NA,NA,none,hothiphop.parents,hot.parents
2019,1,WCR2019_1369,3,WCR2019_0223,WCR2019_0088,within-group subordinate,within-group subordinate,55,23,32,21,35,44,58,1,99999,424,548,329,0.41304347826087,0,0,NA,NA,none,hothiphop.parents,hot.parents
2019,1,WCR2019_1370,1,WCR2019_0534,WCR2019_0447,within-group subordinate,within-group subordinate,2,0,2,0,2,0,2,1,99999,854,840,835,0.419091967403958,0,0,NA,NA,none,hothiphop.parents,hot.parents
2019,1,WCR2019_1370,2,WCR2019_0223,WCR2019_0447,within-group subordinate,within-group subordinate,42,25,17,18,2,43,27,1,99999,489,840,475,0.419091967403958,0,0,NA,NA,none,hothiphop.parents,hot.parents
2019,1,WCR2019_1370,3,WCR2019_0361,WCR2019_0447,within-group subordinate,within-group subordinate,46,22,24,25,2,47,24,1,99999,799,840,782,0.419091967403958,0,0,NA,NA,none,hothiphop.parents,hot.parents
2019,1,WCR2019_1371,1,WCR2019_0223,WCR2019_0061,within-group subordinate,within-group subordinate,62,23,39,32,36,55,59,1,99999,463,710,404,0.328339575530587,0,0,NA,NA,none,hothiphop.parents,hot.parents
2019,1,WCR2019_1371,2,WCR2019_0223,WCR2019_0087,within-group subordinate,within-group subordinate,62,21,41,32,45,53,66,1,99999,463,581,335,0.328339575530587,0,0,NA,NA,none,hothiphop.parents,hot.parents
2019,1,WCR2019_1371,3,WCR2019_0223,WCR2019_0327,within-group subordinate,within-group subordinate,68,29,39,32,19,61,48,1,99999,463,771,448,0.328339575530587,0,0,NA,NA,none,hothiphop.parents,hot.parents
2019,1,WCR2019_1372,1,WCR2019_0223,WCR2019_0299,within-group subordinate,within-group subordinate,57,31,26,25,3,56,34,1,99999,446,766,442,0.430967741935484,0,0,NA,NA,none,hothiphop.parents,hot.parents
2019,1,WCR2019_1372,2,WCR2019_0440,WCR2019_0299,within-group subordinate,within-group subordinate,58,36,22,21,3,57,39,1,99999,512,766,509,0.430967741935484,0,0,NA,NA,none,hothiphop.parents,hot.parents
2019,1,WCR2019_1372,3,WCR2019_0223,WCR2019_0327,within-group subordinate,within-group subordinate,62,31,31,25,18,56,49,1,99999,446,750,434,0.430967741935484,0,0,NA,NA,none,hothiphop.parents,hot.parents
2019,1,WCR2019_1373,1,WCR2019_0267,WCR2019_0122,within-group subordinate,within-group subordinate,34,26,8,5,6,31,32,1,99999,809,810,800,0.285714285714286,0,0,NA,NA,none,hothiphop.parents,hot.parents
2019,1,WCR2019_1373,2,WCR2019_0361,WCR2019_0122,within-group subordinate,within-group subordinate,34,24,10,8,6,32,30,1,99999,769,810,760,0.285714285714286,0,0,NA,NA,none,hothiphop.parents,hot.parents
2019,1,WCR2019_1373,3,WCR2019_0263,WCR2019_0327,within-group subordinate,within-group subordinate,34,24,10,5,8,29,32,1,99999,812,791,786,0.285714285714286,0,0,NA,NA,none,hothiphop.parents,hot.parents
2019,1,WCR2019_1375,1,WCR2019_0223,WCR2019_0088,within-group subordinate,within-group subordinate,27,17,10,11,1,28,18,1,99999,468,613,363,0.477356181150551,0,0,NA,NA,none,hothiphop.parents,hot.parents
2019,1,WCR2019_1375,2,WCR2019_0223,WCR2019_0161,within-group subordinate,within-group subordinate,31,19,12,11,3,30,22,1,99999,468,768,449,0.477356181150551,0,0,NA,NA,none,hothiphop.parents,hot.parents
2019,1,WCR2019_1375,3,WCR2019_0223,WCR2019_0417,within-group subordinate,within-group subordinate,33,21,12,11,1,32,22,1,99999,468,815,466,0.477356181150551,0,0,NA,NA,none,hothiphop.parents,hot.parents
2019,1,WCR2019_1376,1,WCR2019_0223,WCR2019_0087,within-group subordinate,within-group subordinate,62,19,43,24,44,43,63,1,99999,476,610,346,0.38452380952381,0,0,NA,NA,none,hothiphop.parents,hot.parents
2019,1,WCR2019_1376,2,WCR2019_0223,WCR2019_0327,within-group subordinate,within-group subordinate,64,33,31,24,24,57,57,1,99999,476,810,462,0.38452380952381,0,0,NA,NA,none,hothiphop.parents,hot.parents
2019,1,WCR2019_1376,3,WCR2019_0440,WCR2019_0087,within-group subordinate,within-group subordinate,66,26,40,23,44,49,70,1,99999,558,610,406,0.38452380952381,0,0,NA,NA,none,hothiphop.parents,hot.parents
2019,1,WCR2019_1377,1,WCR2019_0223,WCR2019_0327,within-group subordinate,within-group subordinate,43,22,21,20,7,42,29,1,99999,478,808,463,0.406921241050119,0,0,NA,NA,none,hothiphop.parents,hot.parents
2019,1,WCR2019_1377,2,WCR2019_0223,WCR2019_0061,within-group subordinate,within-group subordinate,47,19,28,20,23,39,42,1,99999,478,743,416,0.406921241050119,0,0,NA,NA,none,hothiphop.parents,hot.parents
2019,1,WCR2019_1377,3,WCR2019_0223,WCR2019_0075,within-group subordinate,within-group subordinate,49,26,23,20,23,46,49,1,99999,478,733,410,0.406921241050119,0,0,NA,NA,none,hothiphop.parents,hot.parents
2019,1,WCR2019_1378,1,WCR2019_0421,WCR2019_0258,within-group subordinate,within-group subordinate,1,1,0,0,0,1,1,1,99999,602,595,594,0.482587064676617,0,0,NA,NA,none,hothiphop.parents,hot.parents
2019,1,WCR2019_1378,2,WCR2019_0421,WCR2019_0327,within-group subordinate,within-group subordinate,31,26,5,0,5,26,31,1,99999,602,582,581,0.482587064676617,0,0,NA,NA,none,hothiphop.parents,hot.parents
2019,1,WCR2019_1378,3,WCR2019_0421,WCR2019_0088,within-group subordinate,within-group subordinate,38,31,7,0,7,31,38,1,99999,602,464,463,0.482587064676617,0,0,NA,NA,none,hothiphop.parents,hot.parents
2019,1,WCR2019_1379,1,WCR2019_0223,WCR2019_0087,within-group subordinate,within-group subordinate,47,22,25,19,21,41,43,1,99999,387,502,285,0.489736070381232,0,0,NA,NA,none,hothiphop.parents,hot.parents
2019,1,WCR2019_1379,2,WCR2019_0440,WCR2019_0327,within-group subordinate,within-group subordinate,54,35,19,15,18,50,53,1,99999,446,660,433,0.489736070381232,0,0,NA,NA,none,hothiphop.parents,hot.parents
2019,1,WCR2019_1379,3,WCR2019_0440,WCR2019_0122,within-group subordinate,within-group subordinate,54,32,22,15,19,47,51,1,99999,446,672,441,0.489736070381232,0,0,NA,NA,none,hothiphop.parents,hot.parents
2019,1,WCR2019_1380,1,WCR2019_0223,WCR2019_0087,within-group subordinate,within-group subordinate,54,15,39,25,45,40,60,1,99999,439,555,316,0.386631716906946,0,0,NA,NA,none,hothiphop.parents,hot.parents
2019,1,WCR2019_1380,2,WCR2019_0223,WCR2019_0088,within-group subordinate,within-group subordinate,67,28,39,25,42,53,70,1,99999,439,566,340,0.386631716906946,0,0,NA,NA,none,hothiphop.parents,hot.parents
2019,1,WCR2019_1380,3,WCR2019_0440,WCR2019_0087,within-group subordinate,within-group subordinate,68,20,48,34,45,54,65,1,99999,513,555,372,0.386631716906946,0,0,NA,NA,none,hothiphop.parents,hot.parents
2019,1,WCR2019_1381,1,WCR2019_0223,WCR2019_0088,within-group subordinate,within-group subordinate,34,25,9,11,1,36,26,1,99999,476,630,371,0.511961722488038,0,0,NA,NA,none,hothiphop.parents,hot.parents
2019,1,WCR2019_1381,2,WCR2019_0223,WCR2019_0327,within-group subordinate,within-group subordinate,36,23,13,11,3,34,26,1,99999,476,806,462,0.511961722488038,0,0,NA,NA,none,hothiphop.parents,hot.parents
2019,1,WCR2019_1381,3,WCR2019_0440,WCR2019_0122,within-group subordinate,within-group subordinate,37,23,14,14,1,37,24,1,99999,554,824,548,0.511961722488038,0,0,NA,NA,none,hothiphop.parents,hot.parents
2019,1,WCR2019_1383,1,WCR2019_0252,WCR2019_0405,within-group subordinate,within-group subordinate,0,0,0,0,0,0,0,1,99999,802,759,757,0.0609452736318408,0,0,NA,NA,none,hothiphop.parents,hot.parents
2019,1,WCR2019_1383,2,WCR2019_0260,WCR2019_0405,within-group subordinate,within-group subordinate,4,1,3,3,0,4,1,1,99999,793,759,749,0.0609452736318408,0,0,NA,NA,none,hothiphop.parents,hot.parents
2019,1,WCR2019_1383,3,WCR2019_0252,WCR2019_0518,within-group subordinate,within-group subordinate,4,1,3,0,3,1,4,1,99999,802,796,794,0.0609452736318408,0,0,NA,NA,none,hothiphop.parents,hot.parents
2019,1,WCR2019_1384,1,WCR2019_0440,WCR2019_0122,within-group subordinate,within-group subordinate,46,23,23,18,17,41,40,1,99999,539,797,533,0.440049443757726,0,0,NA,NA,none,hothiphop.parents,hot.parents
2019,1,WCR2019_1384,2,WCR2019_0223,WCR2019_0327,within-group subordinate,within-group subordinate,48,25,23,18,9,43,34,1,99999,466,780,452,0.440049443757726,0,0,NA,NA,none,hothiphop.parents,hot.parents
2019,1,WCR2019_1384,3,WCR2019_0440,WCR2019_0327,within-group subordinate,within-group subordinate,52,32,20,18,9,50,41,1,99999,539,780,521,0.440049443757726,0,0,NA,NA,none,hothiphop.parents,hot.parents
2019,1,WCR2019_1385,1,WCR2019_0223,WCR2019_0602,within-group subordinate,within-group subordinate,46,23,23,23,1,46,24,1,99999,476,830,476,0.376950780312125,0,0,NA,NA,none,hothiphop.parents,hot.parents
2019,1,WCR2019_1385,2,WCR2019_0223,WCR2019_0061,within-group subordinate,within-group subordinate,52,21,31,23,30,44,51,1,99999,476,739,415,0.376950780312125,0,0,NA,NA,none,hothiphop.parents,hot.parents
2019,1,WCR2019_1385,3,WCR2019_0223,WCR2019_0327,within-group subordinate,within-group subordinate,52,21,31,23,27,44,48,1,99999,476,806,463,0.376950780312125,0,0,NA,NA,none,hothiphop.parents,hot.parents
2019,1,WCR2019_1387,1,WCR2019_0223,WCR2019_0087,within-group subordinate,within-group subordinate,58,24,34,27,35,51,59,1,99999,487,624,354,0.384345794392523,0,0,NA,NA,none,hothiphop.parents,hot.parents
2019,1,WCR2019_1387,2,WCR2019_0223,WCR2019_0461,within-group subordinate,within-group subordinate,59,31,28,27,3,58,34,1,99999,487,852,486,0.384345794392523,0,0,NA,NA,none,hothiphop.parents,hot.parents
2019,1,WCR2019_1387,3,WCR2019_0223,WCR2019_0061,within-group subordinate,within-group subordinate,64,29,35,27,37,56,66,1,99999,487,758,424,0.384345794392523,0,0,NA,NA,none,hothiphop.parents,hot.parents
2019,1,WCR2019_1388,1,WCR2019_0223,WCR2019_0087,within-group subordinate,within-group subordinate,57,22,35,21,39,43,61,1,99999,477,601,346,0.409855769230769,0,0,NA,NA,none,hothiphop.parents,hot.parents
2019,1,WCR2019_1388,2,WCR2019_0223,WCR2019_0088,within-group subordinate,within-group subordinate,62,28,34,21,29,49,57,1,99999,477,621,370,0.409855769230769,0,0,NA,NA,none,hothiphop.parents,hot.parents
2019,1,WCR2019_1388,3,WCR2019_0223,WCR2019_0327,within-group subordinate,within-group subordinate,63,33,30,21,19,54,52,1,99999,477,803,463,0.409855769230769,0,0,NA,NA,none,hothiphop.parents,hot.parents
2019,1,WCR2019_1389,1,WCR2019_0223,WCR2019_0088,within-group subordinate,within-group subordinate,32,22,10,12,1,34,23,1,99999,487,643,379,0.448074679113186,0,0,NA,NA,none,hothiphop.parents,hot.parents
2019,1,WCR2019_1389,2,WCR2019_0223,WCR2019_0039,within-group subordinate,within-group subordinate,41,29,12,12,1,41,30,1,99999,487,836,476,0.448074679113186,0,0,NA,NA,none,hothiphop.parents,hot.parents
2019,1,WCR2019_1389,3,WCR2019_0223,WCR2019_0075,within-group subordinate,within-group subordinate,41,29,12,12,4,41,33,1,99999,487,747,417,0.448074679113186,0,0,NA,NA,none,hothiphop.parents,hot.parents
2019,1,WCR2019_1390,1,WCR2019_0223,WCR2019_0327,within-group subordinate,within-group subordinate,51,24,27,25,23,49,47,1,99999,480,810,465,0.382877526753864,0,0,NA,NA,none,hothiphop.parents,hot.parents
2019,1,WCR2019_1390,2,WCR2019_0440,WCR2019_0122,within-group subordinate,within-group subordinate,54,26,28,20,20,46,46,1,99999,561,829,555,0.382877526753864,0,0,NA,NA,none,hothiphop.parents,hot.parents
2019,1,WCR2019_1390,3,WCR2019_0223,WCR2019_0061,within-group subordinate,within-group subordinate,55,25,30,25,27,50,52,1,99999,480,745,418,0.382877526753864,0,0,NA,NA,none,hothiphop.parents,hot.parents
2019,1,WCR2019_1392,1,WCR2019_0223,WCR2019_0088,within-group subordinate,within-group subordinate,45,21,24,21,18,42,39,1,99999,489,642,381,0.411007025761124,0,0,NA,NA,none,hothiphop.parents,hot.parents
2019,1,WCR2019_1392,2,WCR2019_0223,WCR2019_0327,within-group subordinate,within-group subordinate,50,24,26,21,9,45,33,1,99999,489,824,474,0.411007025761124,0,0,NA,NA,none,hothiphop.parents,hot.parents
2019,1,WCR2019_1392,3,WCR2019_0223,WCR2019_0407,within-group subordinate,within-group subordinate,52,26,26,21,18,47,44,1,99999,489,848,485,0.411007025761124,0,0,NA,NA,none,hothiphop.parents,hot.parents
2019,1,WCR2019_1394,1,WCR2019_0223,WCR2019_0088,within-group subordinate,within-group subordinate,51,21,30,22,31,43,52,1,99999,486,635,379,0.411556603773585,0,0,NA,NA,none,hothiphop.parents,hot.parents
2019,1,WCR2019_1394,2,WCR2019_0223,WCR2019_0161,within-group subordinate,within-group subordinate,55,29,26,22,20,51,49,1,99999,486,798,467,0.411556603773585,0,0,NA,NA,none,hothiphop.parents,hot.parents
2019,1,WCR2019_1394,3,WCR2019_0223,WCR2019_0327,within-group subordinate,within-group subordinate,55,28,27,22,13,50,41,1,99999,486,819,471,0.411556603773585,0,0,NA,NA,none,hothiphop.parents,hot.parents
2019,1,WCR2019_1395,1,WCR2019_0223,WCR2019_0061,within-group subordinate,within-group subordinate,45,28,17,16,19,44,47,1,99999,471,728,410,0.398058252427184,0,0,NA,NA,none,hothiphop.parents,hot.parents
2019,1,WCR2019_1395,2,WCR2019_0223,WCR2019_0327,within-group subordinate,within-group subordinate,45,25,20,16,15,41,40,1,99999,471,794,456,0.398058252427184,0,0,NA,NA,none,hothiphop.parents,hot.parents
2019,1,WCR2019_1395,3,WCR2019_0223,WCR2019_0075,within-group subordinate,within-group subordinate,50,29,21,16,30,45,59,1,99999,471,717,402,0.398058252427184,0,0,NA,NA,none,hothiphop.parents,hot.parents
2019,1,WCR2019_1397,1,WCR2019_0496,WCR2019_0088,within-group subordinate,within-group subordinate,17,12,5,3,4,15,16,1,99999,771,593,591,0.214470284237726,0,0,NA,NA,none,hothiphop.parents,hot.parents
2019,1,WCR2019_1397,2,WCR2019_0367,WCR2019_0088,within-group subordinate,within-group subordinate,21,16,5,6,4,22,20,1,99999,769,593,590,0.214470284237726,0,0,NA,NA,none,hothiphop.parents,hot.parents
2019,1,WCR2019_1397,3,WCR2019_0196,WCR2019_0339,within-group subordinate,within-group subordinate,23,17,6,5,3,22,20,1,99999,770,771,767,0.214470284237726,0,0,NA,NA,none,hothiphop.parents,hot.parents
2019,1,WCR2019_1398,1,WCR2019_0522,WCR2019_0537,within-group subordinate,within-group subordinate,3,1,2,0,2,1,3,1,99999,669,668,667,0.282089552238806,0,0,NA,NA,none,hothiphop.parents,hot.parents
2019,1,WCR2019_1398,2,WCR2019_0324,WCR2019_0537,within-group subordinate,within-group subordinate,5,3,2,0,2,3,5,1,99999,670,668,668,0.282089552238806,0,0,NA,NA,none,hothiphop.parents,hot.parents
2019,1,WCR2019_1398,3,WCR2019_0338,WCR2019_0537,within-group subordinate,within-group subordinate,5,2,3,3,2,5,4,1,99999,667,668,665,0.282089552238806,0,0,NA,NA,none,hothiphop.parents,hot.parents
2019,1,WCR2019_1399,1,WCR2019_0334,WCR2019_0157,within-group subordinate,within-group subordinate,2,1,1,1,1,2,2,1,99999,714,711,708,0.0543933054393305,0,0,NA,NA,none,hothiphop.parents,hot.parents
2019,1,WCR2019_1399,2,WCR2019_0252,WCR2019_0405,within-group subordinate,within-group subordinate,3,1,2,2,0,3,1,1,99999,715,675,673,0.0543933054393305,0,0,NA,NA,none,hothiphop.parents,hot.parents
2019,1,WCR2019_1399,3,WCR2019_0252,WCR2019_0157,within-group subordinate,within-group subordinate,3,0,3,2,1,2,1,1,99999,715,711,709,0.0543933054393305,0,0,NA,NA,none,hothiphop.parents,hot.parents
2019,1,WCR2019_1400,1,WCR2019_0440,WCR2019_0327,within-group subordinate,within-group subordinate,60,32,28,22,16,54,48,1,99999,538,783,521,0.402469135802469,0,0,NA,NA,none,hothiphop.parents,hot.parents
2019,1,WCR2019_1400,2,WCR2019_0440,WCR2019_0122,within-group subordinate,within-group subordinate,61,27,34,22,22,49,49,1,99999,538,798,532,0.402469135802469,0,0,NA,NA,none,hothiphop.parents,hot.parents
2019,1,WCR2019_1400,3,WCR2019_0440,WCR2019_0087,within-group subordinate,within-group subordinate,62,23,39,22,40,45,63,1,99999,538,582,386,0.402469135802469,0,0,NA,NA,none,hothiphop.parents,hot.parents
2019,1,WCR2019_1401,1,WCR2019_0223,WCR2019_0088,within-group subordinate,within-group subordinate,50,21,29,29,23,50,44,1,99999,468,619,363,0.42512077294686,0,0,NA,NA,none,hothiphop.parents,hot.parents
2019,1,WCR2019_1401,2,WCR2019_0223,WCR2019_0061,within-group subordinate,within-group subordinate,57,27,30,29,25,56,52,1,99999,468,732,407,0.42512077294686,0,0,NA,NA,none,hothiphop.parents,hot.parents
2019,1,WCR2019_1401,3,WCR2019_0223,WCR2019_0161,within-group subordinate,within-group subordinate,61,31,30,29,19,60,50,1,99999,468,779,450,0.42512077294686,0,0,NA,NA,none,hothiphop.parents,hot.parents
2019,1,WCR2019_1402,1,WCR2019_0440,WCR2019_0122,within-group subordinate,within-group subordinate,26,20,6,6,1,26,21,1,99999,264,349,261,0.746478873239437,0,0,NA,NA,none,hothiphop.parents,hot.parents
2019,1,WCR2019_1402,2,WCR2019_0223,WCR2019_0088,within-group subordinate,within-group subordinate,26,19,7,7,5,26,24,1,99999,226,270,171,0.746478873239437,0,0,NA,NA,none,hothiphop.parents,hot.parents
2019,1,WCR2019_1402,3,WCR2019_0223,WCR2019_0075,within-group subordinate,within-group subordinate,27,20,7,7,3,27,23,1,99999,226,318,193,0.746478873239437,0,0,NA,NA,none,hothiphop.parents,hot.parents
2019,1,WCR2019_1405,1,WCR2019_0440,WCR2019_0327,within-group subordinate,within-group subordinate,46,25,21,16,16,41,41,1,99999,565,821,545,0.389671361502347,0,0,NA,NA,none,hothiphop.parents,hot.parents
2019,1,WCR2019_1405,2,WCR2019_0440,WCR2019_0122,within-group subordinate,within-group subordinate,48,20,28,16,23,36,43,1,99999,565,840,559,0.389671361502347,0,0,NA,NA,none,hothiphop.parents,hot.parents
2019,1,WCR2019_1405,3,WCR2019_0440,WCR2019_0161,within-group subordinate,within-group subordinate,49,22,27,16,29,38,51,1,99999,565,802,542,0.389671361502347,0,0,NA,NA,none,hothiphop.parents,hot.parents
2019,1,WCR2019_1406,1,WCR2019_0223,WCR2019_0088,within-group subordinate,within-group subordinate,41,20,21,19,15,39,35,1,99999,481,633,375,0.469047619047619,0,0,NA,NA,none,hothiphop.parents,hot.parents
2019,1,WCR2019_1406,2,WCR2019_0223,WCR2019_0327,within-group subordinate,within-group subordinate,48,26,22,19,14,45,40,1,99999,481,809,466,0.469047619047619,0,0,NA,NA,none,hothiphop.parents,hot.parents
2019,1,WCR2019_1406,3,WCR2019_0223,WCR2019_0161,within-group subordinate,within-group subordinate,49,26,23,19,16,45,42,1,99999,481,793,462,0.469047619047619,0,0,NA,NA,none,hothiphop.parents,hot.parents
2019,1,WCR2019_1407,1,WCR2019_0223,WCR2019_0327,within-group subordinate,within-group subordinate,58,29,29,28,16,57,45,1,99999,482,818,468,0.382526564344746,0,0,NA,NA,none,hothiphop.parents,hot.parents
2019,1,WCR2019_1407,2,WCR2019_0532,WCR2019_0327,within-group subordinate,within-group subordinate,60,43,17,1,16,44,59,1,99999,836,818,807,0.382526564344746,0,0,NA,NA,none,hothiphop.parents,hot.parents
2019,1,WCR2019_1407,3,WCR2019_0223,WCR2019_0087,within-group subordinate,within-group subordinate,63,23,40,28,39,51,62,1,99999,482,617,351,0.382526564344746,0,0,NA,NA,none,hothiphop.parents,hot.parents
2019,1,WCR2019_1409,1,WCR2019_0223,WCR2019_0327,within-group subordinate,within-group subordinate,52,18,34,31,17,49,35,1,99999,485,816,470,0.363636363636364,0,0,NA,NA,none,hothiphop.parents,hot.parents
2019,1,WCR2019_1409,2,WCR2019_0223,WCR2019_0161,within-group subordinate,within-group subordinate,58,21,37,31,20,52,41,1,99999,485,798,466,0.363636363636364,0,0,NA,NA,none,hothiphop.parents,hot.parents
2019,1,WCR2019_1409,3,WCR2019_0223,WCR2019_0088,within-group subordinate,within-group subordinate,58,20,38,31,30,51,50,1,99999,485,635,377,0.363636363636364,0,0,NA,NA,none,hothiphop.parents,hot.parents
2019,1,WCR2019_1411,1,WCR2019_0223,WCR2019_0327,within-group subordinate,within-group subordinate,49,21,28,23,15,44,36,1,99999,485,823,470,0.425058548009368,0,0,NA,NA,none,hothiphop.parents,hot.parents
2019,1,WCR2019_1411,2,WCR2019_0223,WCR2019_0087,within-group subordinate,within-group subordinate,57,24,33,23,45,47,69,1,99999,485,622,353,0.425058548009368,0,0,NA,NA,none,hothiphop.parents,hot.parents
2019,1,WCR2019_1411,3,WCR2019_0223,WCR2019_0537,within-group subordinate,within-group subordinate,58,32,26,23,17,55,49,1,99999,485,850,483,0.425058548009368,0,0,NA,NA,none,hothiphop.parents,hot.parents
2019,1,WCR2019_1412,1,WCR2019_0223,WCR2019_0087,within-group subordinate,within-group subordinate,54,17,37,32,39,49,56,1,99999,484,622,352,0.396955503512881,0,0,NA,NA,none,hothiphop.parents,hot.parents
2019,1,WCR2019_1412,2,WCR2019_0440,WCR2019_0087,within-group subordinate,within-group subordinate,59,18,41,28,39,46,57,1,99999,565,622,411,0.396955503512881,0,0,NA,NA,none,hothiphop.parents,hot.parents
2019,1,WCR2019_1412,3,WCR2019_0223,WCR2019_0073,within-group subordinate,within-group subordinate,65,21,44,32,42,53,63,1,99999,484,783,434,0.396955503512881,0,0,NA,NA,none,hothiphop.parents,hot.parents
2019,1,WCR2019_1413,1,WCR2019_0223,WCR2019_0087,within-group subordinate,within-group subordinate,56,23,33,26,37,49,60,1,99999,470,585,339,0.399014778325123,0,0,NA,NA,none,hothiphop.parents,hot.parents
2019,1,WCR2019_1413,2,WCR2019_0223,WCR2019_0073,within-group subordinate,within-group subordinate,62,26,36,26,37,52,63,1,99999,470,742,421,0.399014778325123,0,0,NA,NA,none,hothiphop.parents,hot.parents
2019,1,WCR2019_1413,3,WCR2019_0440,WCR2019_0087,within-group subordinate,within-group subordinate,62,24,38,19,37,43,61,1,99999,545,585,395,0.399014778325123,0,0,NA,NA,none,hothiphop.parents,hot.parents
2019,1,WCR2019_1414,1,WCR2019_0223,WCR2019_0327,within-group subordinate,within-group subordinate,33,23,10,8,4,31,27,1,99999,463,790,451,0.491442542787286,0,0,NA,NA,none,hothiphop.parents,hot.parents
2019,1,WCR2019_1414,2,WCR2019_0223,WCR2019_0088,within-group subordinate,within-group subordinate,37,31,6,8,1,39,32,1,99999,463,616,361,0.491442542787286,0,0,NA,NA,none,hothiphop.parents,hot.parents
2019,1,WCR2019_1414,3,WCR2019_0440,WCR2019_0122,within-group subordinate,within-group subordinate,38,24,14,14,1,38,25,1,99999,541,806,535,0.491442542787286,0,0,NA,NA,none,hothiphop.parents,hot.parents
2019,1,WCR2019_1415,1,WCR2019_0223,WCR2019_0327,within-group subordinate,within-group subordinate,62,35,27,23,17,58,52,1,99999,460,773,447,0.428214731585518,0,0,NA,NA,none,hothiphop.parents,hot.parents
2019,1,WCR2019_1415,2,WCR2019_0440,WCR2019_0327,within-group subordinate,within-group subordinate,63,40,23,18,17,58,57,1,99999,531,773,514,0.428214731585518,0,0,NA,NA,none,hothiphop.parents,hot.parents
2019,1,WCR2019_1415,3,WCR2019_0440,WCR2019_0122,within-group subordinate,within-group subordinate,64,32,32,18,25,50,57,1,99999,531,791,526,0.428214731585518,0,0,NA,NA,none,hothiphop.parents,hot.parents
2019,1,WCR2019_1416,1,WCR2019_0223,WCR2019_0161,within-group subordinate,within-group subordinate,42,23,19,18,17,41,40,1,99999,459,749,440,0.414357682619647,0,0,NA,NA,none,hothiphop.parents,hot.parents
2019,1,WCR2019_1416,2,WCR2019_0223,WCR2019_0075,within-group subordinate,within-group subordinate,45,23,22,18,24,41,47,1,99999,459,690,393,0.414357682619647,0,0,NA,NA,none,hothiphop.parents,hot.parents
2019,1,WCR2019_1416,3,WCR2019_0223,WCR2019_0327,within-group subordinate,within-group subordinate,48,26,22,18,16,44,42,1,99999,459,767,445,0.414357682619647,0,0,NA,NA,none,hothiphop.parents,hot.parents
2019,1,WCR2019_1418,1,WCR2019_0223,WCR2019_0088,within-group subordinate,within-group subordinate,38,22,16,20,1,42,23,1,99999,467,610,362,0.383763837638376,0,0,NA,NA,none,hothiphop.parents,hot.parents
2019,1,WCR2019_1418,2,WCR2019_0223,WCR2019_0407,within-group subordinate,within-group subordinate,43,21,22,20,4,41,25,1,99999,467,807,463,0.383763837638376,0,0,NA,NA,none,hothiphop.parents,hot.parents
2019,1,WCR2019_1418,3,WCR2019_0223,WCR2019_0061,within-group subordinate,within-group subordinate,45,25,20,20,14,45,39,1,99999,467,715,404,0.383763837638376,0,0,NA,NA,none,hothiphop.parents,hot.parents
2019,1,WCR2019_1419,1,WCR2019_0318,WCR2019_0122,within-group subordinate,within-group subordinate,23,10,13,2,12,12,22,1,99999,684,674,673,0.275912408759124,0,0,NA,NA,none,hothiphop.parents,hot.parents
2019,1,WCR2019_1419,2,WCR2019_0318,WCR2019_0161,within-group subordinate,within-group subordinate,25,14,11,2,9,16,23,1,99999,684,649,648,0.275912408759124,0,0,NA,NA,none,hothiphop.parents,hot.parents
2019,1,WCR2019_1419,3,WCR2019_0318,WCR2019_0451,within-group subordinate,within-group subordinate,26,10,16,2,16,12,26,1,99999,684,683,682,0.275912408759124,0,0,NA,NA,none,hothiphop.parents,hot.parents
2019,1,WCR2019_1420,1,WCR2019_0223,WCR2019_0327,within-group subordinate,within-group subordinate,53,27,26,22,18,49,45,1,99999,471,800,457,0.427020506634499,0,0,NA,NA,none,hothiphop.parents,hot.parents
2019,1,WCR2019_1420,2,WCR2019_0440,WCR2019_0327,within-group subordinate,within-group subordinate,56,34,22,21,18,55,52,1,99999,552,800,533,0.427020506634499,0,0,NA,NA,none,hothiphop.parents,hot.parents
2019,1,WCR2019_1420,3,WCR2019_0440,WCR2019_0122,within-group subordinate,within-group subordinate,57,28,29,21,24,49,52,1,99999,552,819,547,0.427020506634499,0,0,NA,NA,none,hothiphop.parents,hot.parents
2019,1,WCR2019_1421,1,WCR2019_0223,WCR2019_0327,within-group subordinate,within-group subordinate,47,26,21,15,11,41,37,1,99999,461,771,447,0.451693851944793,0,0,NA,NA,none,hothiphop.parents,hot.parents
2019,1,WCR2019_1421,2,WCR2019_0223,WCR2019_0088,within-group subordinate,within-group subordinate,50,28,22,15,25,43,53,1,99999,461,597,361,0.451693851944793,0,0,NA,NA,none,hothiphop.parents,hot.parents
2019,1,WCR2019_1421,3,WCR2019_0223,WCR2019_0075,within-group subordinate,within-group subordinate,54,35,19,15,24,50,59,1,99999,461,695,397,0.451693851944793,0,0,NA,NA,none,hothiphop.parents,hot.parents
2019,1,WCR2019_1422,1,WCR2019_0440,WCR2019_0087,within-group subordinate,within-group subordinate,68,23,45,23,49,46,72,1,99999,563,621,410,0.399529964747356,0,0,NA,NA,none,hothiphop.parents,hot.parents
2019,1,WCR2019_1422,2,WCR2019_0223,WCR2019_0073,within-group subordinate,within-group subordinate,71,23,48,33,43,56,66,1,99999,482,780,432,0.399529964747356,0,0,NA,NA,none,hothiphop.parents,hot.parents
2019,1,WCR2019_1422,3,WCR2019_0223,WCR2019_0525,within-group subordinate,within-group subordinate,74,29,45,33,47,62,76,1,99999,482,851,482,0.399529964747356,0,0,NA,NA,none,hothiphop.parents,hot.parents
2019,1,WCR2019_1423,1,WCR2019_0223,WCR2019_0327,within-group subordinate,within-group subordinate,39,26,13,13,8,39,34,1,99999,472,789,457,0.444444444444444,0,0,NA,NA,none,hothiphop.parents,hot.parents
2019,1,WCR2019_1423,2,WCR2019_0440,WCR2019_0122,within-group subordinate,within-group subordinate,44,22,22,14,15,36,37,1,99999,542,807,536,0.444444444444444,0,0,NA,NA,none,hothiphop.parents,hot.parents
2019,1,WCR2019_1423,3,WCR2019_0440,WCR2019_0327,within-group subordinate,within-group subordinate,46,34,12,14,8,48,42,1,99999,542,789,523,0.444444444444444,0,0,NA,NA,none,hothiphop.parents,hot.parents
2019,1,WCR2019_1424,1,WCR2019_0223,WCR2019_0088,within-group subordinate,within-group subordinate,25,13,12,9,10,22,23,1,99999,448,584,350,0.474293059125964,0,0,NA,NA,none,hothiphop.parents,hot.parents
2019,1,WCR2019_1424,2,WCR2019_0223,WCR2019_0327,within-group subordinate,within-group subordinate,34,22,12,9,6,31,28,1,99999,448,748,434,0.474293059125964,0,0,NA,NA,none,hothiphop.parents,hot.parents
2019,1,WCR2019_1424,3,WCR2019_0223,WCR2019_0331,within-group subordinate,within-group subordinate,35,24,11,9,5,33,29,1,99999,448,773,444,0.474293059125964,0,0,NA,NA,none,hothiphop.parents,hot.parents
2019,1,WCR2019_1425,1,WCR2019_0440,WCR2019_0066,within-group subordinate,within-group subordinate,53,27,26,26,0,53,27,1,99999,557,834,552,0.375446960667461,0,0,NA,NA,none,hothiphop.parents,hot.parents
2019,1,WCR2019_1425,2,WCR2019_0223,WCR2019_0088,within-group subordinate,within-group subordinate,63,29,34,33,28,62,57,1,99999,480,631,374,0.375446960667461,0,0,NA,NA,none,hothiphop.parents,hot.parents
2019,1,WCR2019_1425,3,WCR2019_0191,WCR2019_0066,within-group subordinate,within-group subordinate,64,32,32,33,0,65,32,1,99999,637,834,633,0.375446960667461,0,0,NA,NA,none,hothiphop.parents,hot.parents
2019,1,WCR2019_1477,1,WCR2019_0223,WCR2019_0327,within-group subordinate,within-group subordinate,53,31,22,23,13,54,44,1,99999,485,822,471,0.374853113983549,0,0,NA,NA,none,hothiphop.parents,hot.parents
2019,1,WCR2019_1477,2,WCR2019_0223,WCR2019_0087,within-group subordinate,within-group subordinate,55,23,32,23,38,46,61,1,99999,485,620,353,0.374853113983549,0,0,NA,NA,none,hothiphop.parents,hot.parents
2019,1,WCR2019_1477,3,WCR2019_0440,WCR2019_0087,within-group subordinate,within-group subordinate,64,27,37,22,38,49,65,1,99999,564,620,410,0.374853113983549,0,0,NA,NA,none,hothiphop.parents,hot.parents
2019,1,WCR2019_1478,1,WCR2019_0223,WCR2019_0088,within-group subordinate,within-group subordinate,41,19,22,16,29,35,48,1,99999,488,645,380,0.386946386946387,0,0,NA,NA,none,hothiphop.parents,hot.parents
2019,1,WCR2019_1478,2,WCR2019_0223,WCR2019_0475,within-group subordinate,within-group subordinate,45,27,18,16,3,43,30,1,99999,488,856,487,0.386946386946387,0,0,NA,NA,none,hothiphop.parents,hot.parents
2019,1,WCR2019_1478,3,WCR2019_0223,WCR2019_0327,within-group subordinate,within-group subordinate,46,25,21,16,15,41,40,1,99999,488,827,473,0.386946386946387,0,0,NA,NA,none,hothiphop.parents,hot.parents
2019,1,WCR2019_1479,1,WCR2019_0474,WCR2019_0327,within-group subordinate,within-group subordinate,26,17,9,5,5,22,22,1,99999,736,825,711,0.253504672897196,0,0,NA,NA,none,hothiphop.parents,hot.parents
2019,1,WCR2019_1479,2,WCR2019_0165,WCR2019_0327,within-group subordinate,within-group subordinate,29,20,9,7,5,27,25,1,99999,850,825,819,0.253504672897196,0,0,NA,NA,none,hothiphop.parents,hot.parents
2019,1,WCR2019_1479,3,WCR2019_0263,WCR2019_0327,within-group subordinate,within-group subordinate,29,20,9,6,5,26,25,1,99999,848,825,819,0.253504672897196,0,0,NA,NA,none,hothiphop.parents,hot.parents
2019,1,WCR2019_1480,1,WCR2019_0223,WCR2019_0088,within-group subordinate,within-group subordinate,36,24,12,12,12,36,36,1,99999,486,643,379,0.446261682242991,0,0,NA,NA,none,hothiphop.parents,hot.parents
2019,1,WCR2019_1480,2,WCR2019_0223,WCR2019_0327,within-group subordinate,within-group subordinate,40,24,16,12,9,36,33,1,99999,486,825,471,0.446261682242991,0,0,NA,NA,none,hothiphop.parents,hot.parents
2019,1,WCR2019_1480,3,WCR2019_0223,WCR2019_0047,within-group subordinate,within-group subordinate,41,26,15,12,6,38,32,1,99999,486,855,485,0.446261682242991,0,0,NA,NA,none,hothiphop.parents,hot.parents
2019,1,WCR2019_1482,1,WCR2019_0223,WCR2019_0061,within-group subordinate,within-group subordinate,62,25,37,28,38,53,63,1,99999,486,759,424,0.372663551401869,0,0,NA,NA,none,hothiphop.parents,hot.parents
2019,1,WCR2019_1482,2,WCR2019_0223,WCR2019_0087,within-group subordinate,within-group subordinate,64,21,43,28,46,49,67,1,99999,486,625,355,0.372663551401869,0,0,NA,NA,none,hothiphop.parents,hot.parents
2019,1,WCR2019_1482,3,WCR2019_0223,WCR2019_0073,within-group subordinate,within-group subordinate,68,28,40,28,47,56,75,1,99999,486,784,435,0.372663551401869,0,0,NA,NA,none,hothiphop.parents,hot.parents
2019,1,WCR2019_1483,1,WCR2019_0223,WCR2019_0327,within-group subordinate,within-group subordinate,57,24,33,27,24,51,48,1,99999,487,826,472,0.354725787631272,0,0,NA,NA,none,hothiphop.parents,hot.parents
2019,1,WCR2019_1483,2,WCR2019_0440,WCR2019_0087,within-group subordinate,within-group subordinate,66,29,37,25,40,54,69,1,99999,566,625,412,0.354725787631272,0,0,NA,NA,none,hothiphop.parents,hot.parents
2019,1,WCR2019_1483,3,WCR2019_0223,WCR2019_0087,within-group subordinate,within-group subordinate,66,23,43,27,40,50,63,1,99999,487,625,354,0.354725787631272,0,0,NA,NA,none,hothiphop.parents,hot.parents
2019,1,WCR2019_1484,1,WCR2019_0440,WCR2019_0122,within-group subordinate,within-group subordinate,41,21,20,15,13,36,34,1,99999,559,828,553,0.41547619047619,0,0,NA,NA,none,hothiphop.parents,hot.parents
2019,1,WCR2019_1484,2,WCR2019_0223,WCR2019_0088,within-group subordinate,within-group subordinate,43,20,23,22,12,42,32,1,99999,481,632,375,0.41547619047619,0,0,NA,NA,none,hothiphop.parents,hot.parents
2019,1,WCR2019_1484,3,WCR2019_0440,WCR2019_0327,within-group subordinate,within-group subordinate,45,29,16,15,8,44,37,1,99999,559,809,539,0.41547619047619,0,0,NA,NA,none,hothiphop.parents,hot.parents
2019,1,WCR2019_1485,1,WCR2019_0223,WCR2019_0161,within-group subordinate,within-group subordinate,52,31,21,22,4,53,35,1,99999,487,807,468,0.480746791131855,0,0,NA,NA,none,hothiphop.parents,hot.parents
2019,1,WCR2019_1485,2,WCR2019_0440,WCR2019_0122,within-group subordinate,within-group subordinate,53,30,23,18,9,48,39,1,99999,566,845,560,0.480746791131855,0,0,NA,NA,none,hothiphop.parents,hot.parents
2019,1,WCR2019_1485,3,WCR2019_0223,WCR2019_0088,within-group subordinate,within-group subordinate,53,26,27,22,11,48,37,1,99999,487,645,380,0.480746791131855,0,0,NA,NA,none,hothiphop.parents,hot.parents
2019,1,WCR2019_1486,1,WCR2019_0223,WCR2019_0122,within-group subordinate,within-group subordinate,61,27,34,25,28,52,55,1,99999,488,847,481,0.431897555296857,0,0,NA,NA,none,hothiphop.parents,hot.parents
2019,1,WCR2019_1486,2,WCR2019_0223,WCR2019_0088,within-group subordinate,within-group subordinate,62,24,38,25,43,49,67,1,99999,488,646,381,0.431897555296857,0,0,NA,NA,none,hothiphop.parents,hot.parents
2019,1,WCR2019_1486,3,WCR2019_0440,WCR2019_0122,within-group subordinate,within-group subordinate,63,22,41,27,28,49,50,1,99999,568,847,562,0.431897555296857,0,0,NA,NA,none,hothiphop.parents,hot.parents
2019,1,WCR2019_1487,1,WCR2019_0440,WCR2019_0122,within-group subordinate,within-group subordinate,63,33,30,17,26,50,59,1,99999,557,828,551,0.4,0,0,NA,NA,none,hothiphop.parents,hot.parents
2019,1,WCR2019_1487,2,WCR2019_0223,WCR2019_0087,within-group subordinate,within-group subordinate,63,26,37,24,30,50,56,1,99999,476,614,348,0.4,0,0,NA,NA,none,hothiphop.parents,hot.parents
2019,1,WCR2019_1487,3,WCR2019_0440,WCR2019_0087,within-group subordinate,within-group subordinate,64,31,33,17,30,48,61,1,99999,557,614,403,0.4,0,0,NA,NA,none,hothiphop.parents,hot.parents
2019,1,WCR2019_1488,1,WCR2019_0223,WCR2019_0073,within-group subordinate,within-group subordinate,59,14,45,29,57,43,71,1,99999,482,772,431,0.333333333333333,0,0,NA,NA,none,hothiphop.parents,hot.parents
2019,1,WCR2019_1488,2,WCR2019_0223,WCR2019_0327,within-group subordinate,within-group subordinate,60,23,37,29,26,52,49,1,99999,482,812,467,0.333333333333333,0,0,NA,NA,none,hothiphop.parents,hot.parents
2019,1,WCR2019_1488,3,WCR2019_0223,WCR2019_0087,within-group subordinate,within-group subordinate,60,18,42,29,46,47,64,1,99999,482,617,353,0.333333333333333,0,0,NA,NA,none,hothiphop.parents,hot.parents
2019,1,WCR2019_1490,1,WCR2019_0223,WCR2019_0088,within-group subordinate,within-group subordinate,27,21,6,8,2,29,23,1,99999,458,611,359,0.488198757763975,0,0,NA,NA,none,hothiphop.parents,hot.parents
2019,1,WCR2019_1490,2,WCR2019_0223,WCR2019_0161,within-group subordinate,within-group subordinate,29,21,8,8,2,29,23,1,99999,458,758,440,0.488198757763975,0,0,NA,NA,none,hothiphop.parents,hot.parents
2019,1,WCR2019_1490,3,WCR2019_0440,WCR2019_0122,within-group subordinate,within-group subordinate,29,20,9,9,2,29,22,1,99999,537,795,532,0.488198757763975,0,0,NA,NA,none,hothiphop.parents,hot.parents
2019,1,WCR2019_1492,1,WCR2019_0223,WCR2019_0088,within-group subordinate,within-group subordinate,36,26,10,15,3,41,29,1,99999,463,618,365,0.492592592592593,0,0,NA,NA,none,hothiphop.parents,hot.parents
2019,1,WCR2019_1492,2,WCR2019_0191,WCR2019_0088,within-group subordinate,within-group subordinate,40,29,11,14,3,43,32,1,99999,612,618,454,0.492592592592593,0,0,NA,NA,none,hothiphop.parents,hot.parents
2019,1,WCR2019_1492,3,WCR2019_0223,WCR2019_0206,within-group subordinate,within-group subordinate,41,26,15,15,3,41,29,1,99999,463,798,460,0.492592592592593,0,0,NA,NA,none,hothiphop.parents,hot.parents
2019,1,WCR2019_1500,1,WCR2019_0223,WCR2019_0088,within-group subordinate,within-group subordinate,34,22,12,14,1,36,23,1,99999,488,645,380,0.483119906868452,0,0,NA,NA,none,hothiphop.parents,hot.parents
2019,1,WCR2019_1500,2,WCR2019_0223,WCR2019_0161,within-group subordinate,within-group subordinate,38,25,13,14,1,39,26,1,99999,488,809,469,0.483119906868452,0,0,NA,NA,none,hothiphop.parents,hot.parents
2019,1,WCR2019_1500,3,WCR2019_0223,WCR2019_0122,within-group subordinate,within-group subordinate,39,23,16,14,2,37,25,1,99999,488,847,481,0.483119906868452,0,0,NA,NA,none,hothiphop.parents,hot.parents
2019,1,WCR2019_1501,1,WCR2019_0223,WCR2019_0075,within-group subordinate,within-group subordinate,58,34,24,18,36,52,70,1,99999,489,747,419,0.418903150525088,0,0,NA,NA,none,hothiphop.parents,hot.parents
2019,1,WCR2019_1501,2,WCR2019_0223,WCR2019_0327,within-group subordinate,within-group subordinate,59,34,25,18,19,52,53,1,99999,489,826,474,0.418903150525088,0,0,NA,NA,none,hothiphop.parents,hot.parents
2019,1,WCR2019_1501,3,WCR2019_0223,WCR2019_0061,within-group subordinate,within-group subordinate,62,30,32,18,40,48,70,1,99999,489,759,426,0.418903150525088,0,0,NA,NA,none,hothiphop.parents,hot.parents
2019,1,WCR2019_1502,1,WCR2019_0579,WCR2019_0405,within-group subordinate,within-group subordinate,3,1,2,3,0,4,1,1,99999,845,801,795,0.0587544065804935,0,0,NA,NA,none,hothiphop.parents,hot.parents
2019,1,WCR2019_1502,2,WCR2019_0119,WCR2019_0405,within-group subordinate,within-group subordinate,4,3,1,5,0,8,3,1,99999,850,801,801,0.0587544065804935,0,0,NA,NA,none,hothiphop.parents,hot.parents
2019,1,WCR2019_1502,3,WCR2019_0252,WCR2019_0405,within-group subordinate,within-group subordinate,4,2,2,3,0,5,2,1,99999,848,801,798,0.0587544065804935,0,0,NA,NA,none,hothiphop.parents,hot.parents
2019,1,WCR2019_1504,1,WCR2019_0361,WCR2019_0327,within-group subordinate,within-group subordinate,53,44,9,2,8,46,52,1,99999,795,822,772,0.397420867526378,0,0,NA,NA,none,hothiphop.parents,hot.parents
2019,1,WCR2019_1504,2,WCR2019_0223,WCR2019_0327,within-group subordinate,within-group subordinate,53,30,23,20,8,50,38,1,99999,484,822,469,0.397420867526378,0,0,NA,NA,none,hothiphop.parents,hot.parents
2019,1,WCR2019_1504,3,WCR2019_0223,WCR2019_0331,within-group subordinate,within-group subordinate,53,30,23,20,6,50,36,1,99999,484,847,479,0.397420867526378,0,0,NA,NA,none,hothiphop.parents,hot.parents
2019,1,WCR2019_1506,1,WCR2019_0252,WCR2019_0405,within-group subordinate,within-group subordinate,2,0,2,2,0,2,0,1,99999,833,789,786,0.0538277511961723,0,0,NA,NA,none,hothiphop.parents,hot.parents
2019,1,WCR2019_1506,2,WCR2019_0579,WCR2019_0405,within-group subordinate,within-group subordinate,3,1,2,2,0,3,1,1,99999,830,789,783,0.0538277511961723,0,0,NA,NA,none,hothiphop.parents,hot.parents
2019,1,WCR2019_1506,3,WCR2019_0119,WCR2019_0405,within-group subordinate,within-group subordinate,4,2,2,4,0,6,2,1,99999,835,789,789,0.0538277511961723,0,0,NA,NA,none,hothiphop.parents,hot.parents
2019,1,WCR2019_1507,1,WCR2019_0489,WCR2019_0516,within-group subordinate,within-group subordinate,9,5,4,2,3,7,8,1,99999,853,846,845,0.429742388758782,0,0,NA,NA,none,hothiphop.parents,hot.parents
2019,1,WCR2019_1507,2,WCR2019_0334,WCR2019_0516,within-group subordinate,within-group subordinate,9,4,5,2,3,6,7,1,99999,852,846,844,0.429742388758782,0,0,NA,NA,none,hothiphop.parents,hot.parents
2019,1,WCR2019_1507,3,WCR2019_0256,WCR2019_0516,within-group subordinate,within-group subordinate,10,7,3,1,3,8,10,1,99999,851,846,843,0.429742388758782,0,0,NA,NA,none,hothiphop.parents,hot.parents
2019,1,WCR2019_1508,1,WCR2019_0119,WCR2019_0405,within-group subordinate,within-group subordinate,5,3,2,5,0,8,3,1,99999,849,801,801,0.0552941176470588,0,0,NA,NA,none,hothiphop.parents,hot.parents
2019,1,WCR2019_1508,2,WCR2019_0252,WCR2019_0405,within-group subordinate,within-group subordinate,5,2,3,4,0,6,2,1,99999,847,801,798,0.0552941176470588,0,0,NA,NA,none,hothiphop.parents,hot.parents
2019,1,WCR2019_1508,3,WCR2019_0579,WCR2019_0405,within-group subordinate,within-group subordinate,6,3,3,4,0,7,3,1,99999,844,801,795,0.0552941176470588,0,0,NA,NA,none,hothiphop.parents,hot.parents
2019,1,WCR2019_1509,1,WCR2019_0252,WCR2019_0388,within-group subordinate,within-group subordinate,6,2,4,2,2,4,4,1,99999,854,855,852,0.0560093348891482,0,0,NA,NA,none,hothiphop.parents,hot.parents
2019,1,WCR2019_1509,2,WCR2019_0252,WCR2019_0157,within-group subordinate,within-group subordinate,7,2,5,2,4,4,6,1,99999,854,850,847,0.0560093348891482,0,0,NA,NA,none,hothiphop.parents,hot.parents
2019,1,WCR2019_1509,3,WCR2019_0252,WCR2019_0088,within-group subordinate,within-group subordinate,8,3,5,2,4,5,7,1,99999,854,644,642,0.0560093348891482,0,0,NA,NA,none,hothiphop.parents,hot.parents
2019,1,WCR2019_1510,1,WCR2019_0223,WCR2019_0087,within-group subordinate,within-group subordinate,70,27,43,30,38,57,65,1,99999,470,602,343,0.391777509068924,0,0,NA,NA,none,hothiphop.parents,hot.parents
2019,1,WCR2019_1510,2,WCR2019_0223,WCR2019_0327,within-group subordinate,within-group subordinate,72,38,34,30,22,68,60,1,99999,470,796,455,0.391777509068924,0,0,NA,NA,none,hothiphop.parents,hot.parents
2019,1,WCR2019_1510,3,WCR2019_0440,WCR2019_0087,within-group subordinate,within-group subordinate,72,30,42,21,38,51,68,1,99999,550,602,401,0.391777509068924,0,0,NA,NA,none,hothiphop.parents,hot.parents
2019,1,WCR2019_1512,1,WCR2019_0536,WCR2019_0463,within-group subordinate,within-group subordinate,4,1,3,2,1,3,2,1,99999,837,854,837,0.394613583138173,0,0,NA,NA,none,hothiphop.parents,hot.parents
2019,1,WCR2019_1512,2,WCR2019_0536,WCR2019_0327,within-group subordinate,within-group subordinate,50,31,19,2,19,33,50,1,99999,837,823,809,0.394613583138173,0,0,NA,NA,none,hothiphop.parents,hot.parents
2019,1,WCR2019_1512,3,WCR2019_0223,WCR2019_0327,within-group subordinate,within-group subordinate,53,26,27,23,19,49,45,1,99999,487,823,472,0.394613583138173,0,0,NA,NA,none,hothiphop.parents,hot.parents
2019,1,WCR2019_1513,1,WCR2019_0223,WCR2019_0087,within-group subordinate,within-group subordinate,50,36,14,6,17,42,53,1,99999,472,607,342,0.65947242206235,0,0,NA,NA,none,hothiphop.parents,hot.parents
2019,1,WCR2019_1513,2,WCR2019_0223,WCR2019_0327,within-group subordinate,within-group subordinate,57,49,8,6,6,55,55,1,99999,472,805,458,0.65947242206235,0,0,NA,NA,none,hothiphop.parents,hot.parents
2019,1,WCR2019_1513,3,WCR2019_0223,WCR2019_0061,within-group subordinate,within-group subordinate,59,48,11,6,12,54,60,1,99999,472,743,413,0.65947242206235,0,0,NA,NA,none,hothiphop.parents,hot.parents
2019,1,WCR2019_1514,1,WCR2019_0440,WCR2019_0122,within-group subordinate,within-group subordinate,57,22,35,24,33,46,55,1,99999,559,837,553,0.367491166077739,0,0,NA,NA,none,hothiphop.parents,hot.parents
2019,1,WCR2019_1514,2,WCR2019_0440,WCR2019_0161,within-group subordinate,within-group subordinate,61,32,29,24,13,56,45,1,99999,559,799,536,0.367491166077739,0,0,NA,NA,none,hothiphop.parents,hot.parents
2019,1,WCR2019_1514,3,WCR2019_0223,WCR2019_0161,within-group subordinate,within-group subordinate,63,34,29,24,13,58,47,1,99999,481,799,462,0.367491166077739,0,0,NA,NA,none,hothiphop.parents,hot.parents
2019,1,WCR2019_1515,1,WCR2019_0223,WCR2019_0087,within-group subordinate,within-group subordinate,62,22,40,32,43,54,65,1,99999,488,625,355,0.374125874125874,0,0,NA,NA,none,hothiphop.parents,hot.parents
2019,1,WCR2019_1515,2,WCR2019_0223,WCR2019_0327,within-group subordinate,within-group subordinate,68,25,43,32,33,57,58,1,99999,488,827,473,0.374125874125874,0,0,NA,NA,none,hothiphop.parents,hot.parents
2019,1,WCR2019_1515,3,WCR2019_0223,WCR2019_0322,within-group subordinate,within-group subordinate,77,30,47,32,49,62,79,1,99999,488,853,486,0.374125874125874,0,0,NA,NA,none,hothiphop.parents,hot.parents
2019,1,WCR2019_1518,1,WCR2019_0534,WCR2019_0066,within-group subordinate,within-group subordinate,24,17,7,6,1,23,18,1,99999,846,846,841,0.397179788484136,0,0,NA,NA,none,hothiphop.parents,hot.parents
2019,1,WCR2019_1518,2,WCR2019_0011,WCR2019_0066,within-group subordinate,within-group subordinate,53,32,21,20,1,52,33,1,99999,850,846,845,0.397179788484136,0,0,NA,NA,none,hothiphop.parents,hot.parents
2019,1,WCR2019_1518,3,WCR2019_0487,WCR2019_0066,within-group subordinate,within-group subordinate,54,34,20,20,1,54,35,1,99999,846,846,841,0.397179788484136,0,0,NA,NA,none,hothiphop.parents,hot.parents
2019,1,WCR2019_1519,1,WCR2019_0223,WCR2019_0327,within-group subordinate,within-group subordinate,45,20,25,22,13,42,33,1,99999,484,820,469,0.378378378378378,0,0,NA,NA,none,hothiphop.parents,hot.parents
2019,1,WCR2019_1519,2,WCR2019_0223,WCR2019_0087,within-group subordinate,within-group subordinate,46,14,32,22,37,36,51,1,99999,484,619,352,0.378378378378378,0,0,NA,NA,none,hothiphop.parents,hot.parents
2019,1,WCR2019_1519,3,WCR2019_0223,WCR2019_0122,within-group subordinate,within-group subordinate,52,26,26,22,20,48,46,1,99999,484,839,477,0.378378378378378,0,0,NA,NA,none,hothiphop.parents,hot.parents
2019,1,WCR2019_1523,1,WCR2019_0252,WCR2019_0405,within-group subordinate,within-group subordinate,2,0,2,2,0,2,0,1,99999,854,807,804,0.0513418903150525,0,0,NA,NA,none,hothiphop.parents,hot.parents
2019,1,WCR2019_1523,2,WCR2019_0119,WCR2019_0405,within-group subordinate,within-group subordinate,5,2,3,6,0,8,2,1,99999,856,807,807,0.0513418903150525,0,0,NA,NA,none,hothiphop.parents,hot.parents
2019,1,WCR2019_1523,3,WCR2019_0324,WCR2019_0405,within-group subordinate,within-group subordinate,5,2,3,4,0,6,2,1,99999,855,807,805,0.0513418903150525,0,0,NA,NA,none,hothiphop.parents,hot.parents
2019,1,WCR2019_1524,1,WCR2019_0223,WCR2019_0206,within-group subordinate,within-group subordinate,48,32,16,16,3,48,35,1,99999,487,844,484,0.455607476635514,0,0,NA,NA,none,hothiphop.parents,hot.parents
2019,1,WCR2019_1524,2,WCR2019_0223,WCR2019_0061,within-group subordinate,within-group subordinate,51,30,21,16,17,46,47,1,99999,487,758,424,0.455607476635514,0,0,NA,NA,none,hothiphop.parents,hot.parents
2019,1,WCR2019_1524,3,WCR2019_0223,WCR2019_0327,within-group subordinate,within-group subordinate,53,32,21,16,12,48,44,1,99999,487,825,472,0.455607476635514,0,0,NA,NA,none,hothiphop.parents,hot.parents
2019,1,WCR2019_1525,1,WCR2019_0440,WCR2019_0087,within-group subordinate,within-group subordinate,68,30,38,29,31,59,61,1,99999,562,621,409,0.417156286721504,0,0,NA,NA,none,hothiphop.parents,hot.parents
2019,1,WCR2019_1525,2,WCR2019_0440,WCR2019_0516,within-group subordinate,within-group subordinate,69,40,29,29,1,69,41,1,99999,562,843,558,0.417156286721504,0,0,NA,NA,none,hothiphop.parents,hot.parents
2019,1,WCR2019_1525,3,WCR2019_0223,WCR2019_0087,within-group subordinate,within-group subordinate,69,32,37,30,31,62,63,1,99999,482,621,352,0.417156286721504,0,0,NA,NA,none,hothiphop.parents,hot.parents
2019,1,WCR2019_1526,1,WCR2019_0440,WCR2019_0122,within-group subordinate,within-group subordinate,42,22,20,14,14,36,36,1,99999,562,837,556,0.428739693757362,0,0,NA,NA,none,hothiphop.parents,hot.parents
2019,1,WCR2019_1526,2,WCR2019_0223,WCR2019_0088,within-group subordinate,within-group subordinate,44,25,19,12,20,37,45,1,99999,481,637,374,0.428739693757362,0,0,NA,NA,none,hothiphop.parents,hot.parents
2019,1,WCR2019_1526,3,WCR2019_0223,WCR2019_0327,within-group subordinate,within-group subordinate,45,27,18,12,17,39,44,1,99999,481,818,466,0.428739693757362,0,0,NA,NA,none,hothiphop.parents,hot.parents
2019,1,WCR2019_1527,1,WCR2019_0223,WCR2019_0087,within-group subordinate,within-group subordinate,60,24,36,26,41,50,65,1,99999,483,618,350,0.386603995299647,0,0,NA,NA,none,hothiphop.parents,hot.parents
2019,1,WCR2019_1527,2,WCR2019_0223,WCR2019_0088,within-group subordinate,within-group subordinate,63,32,31,26,33,58,65,1,99999,483,637,375,0.386603995299647,0,0,NA,NA,none,hothiphop.parents,hot.parents
2019,1,WCR2019_1527,3,WCR2019_0223,WCR2019_0327,within-group subordinate,within-group subordinate,65,33,32,26,21,59,54,1,99999,483,820,468,0.386603995299647,0,0,NA,NA,none,hothiphop.parents,hot.parents
2019,1,WCR2019_1531,1,WCR2019_0280,WCR2019_0286,within-group subordinate,within-group subordinate,1,0,1,0,1,0,1,1,99999,718,723,712,0.354794520547945,0,0,NA,NA,none,hothiphop.parents,hot.parents
2019,1,WCR2019_1531,2,WCR2019_0280,WCR2019_0122,within-group subordinate,within-group subordinate,27,19,8,0,8,19,27,1,99999,718,719,707,0.354794520547945,0,0,NA,NA,none,hothiphop.parents,hot.parents
2019,1,WCR2019_1531,3,WCR2019_0280,WCR2019_0327,within-group subordinate,within-group subordinate,30,24,6,0,6,24,30,1,99999,718,705,694,0.354794520547945,0,0,NA,NA,none,hothiphop.parents,hot.parents
2019,1,WCR2019_1532,1,WCR2019_0223,WCR2019_0087,within-group subordinate,within-group subordinate,62,24,38,31,50,55,74,1,99999,486,623,354,0.352046783625731,0,0,NA,NA,none,hothiphop.parents,hot.parents
2019,1,WCR2019_1532,2,WCR2019_0223,WCR2019_0327,within-group subordinate,within-group subordinate,63,28,35,31,27,59,55,1,99999,486,825,471,0.352046783625731,0,0,NA,NA,none,hothiphop.parents,hot.parents
2019,1,WCR2019_1532,3,WCR2019_0191,WCR2019_0087,within-group subordinate,within-group subordinate,71,23,48,32,50,55,73,1,99999,646,623,456,0.352046783625731,0,0,NA,NA,none,hothiphop.parents,hot.parents
2019,1,WCR2019_1534,1,WCR2019_0223,WCR2019_0087,within-group subordinate,within-group subordinate,56,24,32,24,37,48,61,1,99999,483,624,356,0.394117647058824,0,0,NA,NA,none,hothiphop.parents,hot.parents
2019,1,WCR2019_1534,2,WCR2019_0223,WCR2019_0516,within-group subordinate,within-group subordinate,61,37,24,24,2,61,39,1,99999,483,842,481,0.394117647058824,0,0,NA,NA,none,hothiphop.parents,hot.parents
2019,1,WCR2019_1534,3,WCR2019_0223,WCR2019_0061,within-group subordinate,within-group subordinate,69,34,35,24,38,58,72,1,99999,483,753,421,0.394117647058824,0,0,NA,NA,none,hothiphop.parents,hot.parents
2019,1,WCR2019_1535,1,WCR2019_0223,WCR2019_0327,within-group subordinate,within-group subordinate,50,25,25,23,17,48,42,1,99999,488,827,473,0.424242424242424,0,0,NA,NA,none,hothiphop.parents,hot.parents
2019,1,WCR2019_1535,2,WCR2019_0223,WCR2019_0047,within-group subordinate,within-group subordinate,52,29,23,23,2,52,31,1,99999,488,857,487,0.424242424242424,0,0,NA,NA,none,hothiphop.parents,hot.parents
2019,1,WCR2019_1535,3,WCR2019_0223,WCR2019_0061,within-group subordinate,within-group subordinate,52,28,24,23,20,51,48,1,99999,488,760,425,0.424242424242424,0,0,NA,NA,none,hothiphop.parents,hot.parents
2019,1,WCR2019_1536,1,WCR2019_0223,WCR2019_0088,within-group subordinate,within-group subordinate,31,23,8,11,3,34,26,1,99999,488,646,381,0.481955762514552,0,0,NA,NA,none,hothiphop.parents,hot.parents
2019,1,WCR2019_1536,2,WCR2019_0223,WCR2019_0331,within-group subordinate,within-group subordinate,34,22,12,11,5,33,27,1,99999,488,853,483,0.481955762514552,0,0,NA,NA,none,hothiphop.parents,hot.parents
2019,1,WCR2019_1536,3,WCR2019_0223,WCR2019_0161,within-group subordinate,within-group subordinate,36,27,9,11,3,38,30,1,99999,488,809,469,0.481955762514552,0,0,NA,NA,none,hothiphop.parents,hot.parents
2019,1,WCR2019_1538,1,WCR2019_0440,WCR2019_0122,within-group subordinate,within-group subordinate,52,21,31,24,23,45,44,1,99999,559,835,553,0.402597402597403,0,0,NA,NA,none,hothiphop.parents,hot.parents
2019,1,WCR2019_1538,2,WCR2019_0223,WCR2019_0061,within-group subordinate,within-group subordinate,55,24,31,25,26,49,50,1,99999,481,751,420,0.402597402597403,0,0,NA,NA,none,hothiphop.parents,hot.parents
2019,1,WCR2019_1538,3,WCR2019_0223,WCR2019_0075,within-group subordinate,within-group subordinate,57,29,28,25,24,54,53,1,99999,481,737,411,0.402597402597403,0,0,NA,NA,none,hothiphop.parents,hot.parents
2019,1,WCR2019_1539,1,WCR2019_0223,WCR2019_0087,within-group subordinate,within-group subordinate,50,23,27,25,31,48,54,1,99999,488,622,355,0.395784543325527,0,0,NA,NA,none,hothiphop.parents,hot.parents
2019,1,WCR2019_1539,2,WCR2019_0223,WCR2019_0327,within-group subordinate,within-group subordinate,65,34,31,25,31,59,65,1,99999,488,823,473,0.395784543325527,0,0,NA,NA,none,hothiphop.parents,hot.parents
2019,1,WCR2019_1539,3,WCR2019_0223,WCR2019_0061,within-group subordinate,within-group subordinate,66,31,35,25,46,56,77,1,99999,488,756,425,0.395784543325527,0,0,NA,NA,none,hothiphop.parents,hot.parents
2019,1,WCR2019_1540,1,WCR2019_0534,WCR2019_0519,within-group subordinate,within-group subordinate,28,19,9,7,2,26,21,1,99999,848,848,844,0.302816901408451,0,0,NA,NA,none,hothiphop.parents,hot.parents
2019,1,WCR2019_1540,2,WCR2019_0011,WCR2019_0519,within-group subordinate,within-group subordinate,40,28,12,12,2,40,30,1,99999,851,848,847,0.302816901408451,0,0,NA,NA,none,hothiphop.parents,hot.parents
2019,1,WCR2019_1540,3,WCR2019_0547,WCR2019_0519,within-group subordinate,within-group subordinate,42,31,11,11,2,42,33,1,99999,850,848,846,0.302816901408451,0,0,NA,NA,none,hothiphop.parents,hot.parents
2019,1,WCR2019_1541,1,WCR2019_0223,WCR2019_0327,within-group subordinate,within-group subordinate,59,32,27,26,17,58,49,1,99999,484,819,469,0.356470588235294,0,0,NA,NA,none,hothiphop.parents,hot.parents
2019,1,WCR2019_1541,2,WCR2019_0440,WCR2019_0087,within-group subordinate,within-group subordinate,64,23,41,23,41,46,64,1,99999,563,619,409,0.356470588235294,0,0,NA,NA,none,hothiphop.parents,hot.parents
2019,1,WCR2019_1541,3,WCR2019_0223,WCR2019_0073,within-group subordinate,within-group subordinate,64,21,43,26,52,47,73,1,99999,484,778,433,0.356470588235294,0,0,NA,NA,none,hothiphop.parents,hot.parents
2019,1,WCR2019_1542,1,WCR2019_0223,WCR2019_0075,within-group subordinate,within-group subordinate,57,31,26,24,31,55,62,1,99999,441,671,375,0.395860284605433,0,0,NA,NA,none,hothiphop.parents,hot.parents
2019,1,WCR2019_1542,2,WCR2019_0223,WCR2019_0327,within-group subordinate,within-group subordinate,58,28,30,24,24,52,52,1,99999,441,746,428,0.395860284605433,0,0,NA,NA,none,hothiphop.parents,hot.parents
2019,1,WCR2019_1542,3,WCR2019_0223,WCR2019_0087,within-group subordinate,within-group subordinate,58,24,34,24,36,48,60,1,99999,441,571,325,0.395860284605433,0,0,NA,NA,none,hothiphop.parents,hot.parents
2019,1,WCR2019_1545,1,WCR2019_0334,WCR2019_0405,within-group subordinate,within-group subordinate,3,1,2,1,1,2,2,1,99999,831,785,782,0.0515587529976019,0,0,NA,NA,none,hothiphop.parents,hot.parents
2019,1,WCR2019_1545,2,WCR2019_0252,WCR2019_0405,within-group subordinate,within-group subordinate,4,1,3,2,1,3,2,1,99999,832,785,783,0.0515587529976019,0,0,NA,NA,none,hothiphop.parents,hot.parents
2019,1,WCR2019_1545,3,WCR2019_0579,WCR2019_0405,within-group subordinate,within-group subordinate,4,0,4,3,1,3,1,1,99999,828,785,779,0.0515587529976019,0,0,NA,NA,none,hothiphop.parents,hot.parents
2019,1,WCR2019_1546,1,WCR2019_0530,WCR2019_0405,within-group subordinate,within-group subordinate,1,0,1,0,1,0,1,1,99999,834,789,788,0.171052631578947,0,0,NA,NA,none,hothiphop.parents,hot.parents
2019,1,WCR2019_1546,2,WCR2019_0530,WCR2019_0039,within-group subordinate,within-group subordinate,3,2,1,0,1,2,3,1,99999,834,815,813,0.171052631578947,0,0,NA,NA,none,hothiphop.parents,hot.parents
2019,1,WCR2019_1546,3,WCR2019_0530,WCR2019_0088,within-group subordinate,within-group subordinate,4,2,2,0,2,2,4,1,99999,834,625,623,0.171052631578947,0,0,NA,NA,none,hothiphop.parents,hot.parents
2019,1,WCR2019_1547,1,WCR2019_0223,WCR2019_0087,within-group subordinate,within-group subordinate,59,22,37,25,39,47,61,1,99999,480,619,352,0.398104265402844,0,0,NA,NA,none,hothiphop.parents,hot.parents
2019,1,WCR2019_1547,2,WCR2019_0223,WCR2019_0327,within-group subordinate,within-group subordinate,60,29,31,25,19,54,48,1,99999,480,813,465,0.398104265402844,0,0,NA,NA,none,hothiphop.parents,hot.parents
2019,1,WCR2019_1547,3,WCR2019_0223,WCR2019_0061,within-group subordinate,within-group subordinate,61,25,36,25,39,50,64,1,99999,480,749,420,0.398104265402844,0,0,NA,NA,none,hothiphop.parents,hot.parents
2019,1,WCR2019_1549,1,WCR2019_0223,WCR2019_0088,within-group subordinate,within-group subordinate,45,23,22,23,17,46,40,1,99999,470,625,370,0.406513872135103,0,0,NA,NA,none,hothiphop.parents,hot.parents
2019,1,WCR2019_1549,2,WCR2019_0223,WCR2019_0327,within-group subordinate,within-group subordinate,47,23,24,23,8,46,31,1,99999,470,799,455,0.406513872135103,0,0,NA,NA,none,hothiphop.parents,hot.parents
2019,1,WCR2019_1549,3,WCR2019_0440,WCR2019_0327,within-group subordinate,within-group subordinate,49,30,19,18,8,48,38,1,99999,550,799,531,0.406513872135103,0,0,NA,NA,none,hothiphop.parents,hot.parents
2019,1,WCR2019_1550,1,WCR2019_0191,WCR2019_0327,within-group subordinate,within-group subordinate,59,30,29,26,14,56,44,1,99999,614,778,591,0.427688504326329,0,0,NA,NA,none,hothiphop.parents,hot.parents
2019,1,WCR2019_1550,2,WCR2019_0223,WCR2019_0327,within-group subordinate,within-group subordinate,61,28,33,28,14,56,42,1,99999,460,778,445,0.427688504326329,0,0,NA,NA,none,hothiphop.parents,hot.parents
2019,1,WCR2019_1550,3,WCR2019_0440,WCR2019_0122,within-group subordinate,within-group subordinate,61,27,34,25,24,52,51,1,99999,536,797,530,0.427688504326329,0,0,NA,NA,none,hothiphop.parents,hot.parents
2019,1,WCR2019_1551,1,WCR2019_0334,WCR2019_0258,within-group subordinate,within-group subordinate,7,6,1,1,0,7,6,1,99999,843,831,828,0.290780141843972,0,0,NA,NA,none,hothiphop.parents,hot.parents
2019,1,WCR2019_1551,2,WCR2019_0474,WCR2019_0258,within-group subordinate,within-group subordinate,9,9,0,0,0,9,9,1,99999,726,831,712,0.290780141843972,0,0,NA,NA,none,hothiphop.parents,hot.parents
2019,1,WCR2019_1551,3,WCR2019_0252,WCR2019_0258,within-group subordinate,within-group subordinate,9,8,1,1,0,9,8,1,99999,843,831,828,0.290780141843972,0,0,NA,NA,none,hothiphop.parents,hot.parents
2019,1,WCR2019_1552,1,WCR2019_0223,WCR2019_0327,within-group subordinate,within-group subordinate,66,34,32,23,26,57,60,1,99999,482,815,467,0.384160756501182,0,0,NA,NA,none,hothiphop.parents,hot.parents
2019,1,WCR2019_1552,2,WCR2019_0223,WCR2019_0061,within-group subordinate,within-group subordinate,66,33,33,23,45,56,78,1,99999,482,750,421,0.384160756501182,0,0,NA,NA,none,hothiphop.parents,hot.parents
2019,1,WCR2019_1552,3,WCR2019_0223,WCR2019_0075,within-group subordinate,within-group subordinate,69,37,32,23,46,60,83,1,99999,482,739,413,0.384160756501182,0,0,NA,NA,none,hothiphop.parents,hot.parents
2019,1,WCR2019_1553,1,WCR2019_0440,WCR2019_0327,within-group subordinate,within-group subordinate,56,28,28,24,21,52,49,1,99999,554,803,534,0.39015606242497,0,0,NA,NA,none,hothiphop.parents,hot.parents
2019,1,WCR2019_1553,2,WCR2019_0223,WCR2019_0088,within-group subordinate,within-group subordinate,59,24,35,32,32,56,56,1,99999,478,631,372,0.39015606242497,0,0,NA,NA,none,hothiphop.parents,hot.parents
2019,1,WCR2019_1553,3,WCR2019_0223,WCR2019_0327,within-group subordinate,within-group subordinate,60,24,36,32,21,56,45,1,99999,478,803,463,0.39015606242497,0,0,NA,NA,none,hothiphop.parents,hot.parents
2019,1,WCR2019_1555,1,WCR2019_0223,WCR2019_0087,within-group subordinate,within-group subordinate,53,28,25,21,33,49,61,1,99999,471,606,346,0.408980582524272,0,0,NA,NA,none,hothiphop.parents,hot.parents
2019,1,WCR2019_1555,2,WCR2019_0440,WCR2019_0087,within-group subordinate,within-group subordinate,61,26,35,25,33,51,59,1,99999,548,606,403,0.408980582524272,0,0,NA,NA,none,hothiphop.parents,hot.parents
2019,1,WCR2019_1555,3,WCR2019_0223,WCR2019_0327,within-group subordinate,within-group subordinate,66,39,27,21,22,60,61,1,99999,471,793,456,0.408980582524272,0,0,NA,NA,none,hothiphop.parents,hot.parents
2019,1,WCR2019_1557,1,WCR2019_0223,WCR2019_0061,within-group subordinate,within-group subordinate,59,24,35,26,39,50,63,1,99999,485,759,423,0.391355140186916,0,0,NA,NA,none,hothiphop.parents,hot.parents
2019,1,WCR2019_1557,2,WCR2019_0223,WCR2019_0327,within-group subordinate,within-group subordinate,63,32,31,26,17,58,49,1,99999,485,825,470,0.391355140186916,0,0,NA,NA,none,hothiphop.parents,hot.parents
2019,1,WCR2019_1557,3,WCR2019_0223,WCR2019_0087,within-group subordinate,within-group subordinate,67,29,38,26,45,55,74,1,99999,485,626,355,0.391355140186916,0,0,NA,NA,none,hothiphop.parents,hot.parents
2019,1,WCR2019_1558,1,WCR2019_0369,WCR2019_0327,within-group subordinate,within-group subordinate,49,36,13,1,12,37,48,1,99999,833,806,805,0.38968824940048,0,0,NA,NA,none,hothiphop.parents,hot.parents
2019,1,WCR2019_1558,2,WCR2019_0369,WCR2019_0122,within-group subordinate,within-group subordinate,52,37,15,1,14,38,51,1,99999,833,823,822,0.38968824940048,0,0,NA,NA,none,hothiphop.parents,hot.parents
2019,1,WCR2019_1558,3,WCR2019_0440,WCR2019_0122,within-group subordinate,within-group subordinate,55,24,31,25,14,49,38,1,99999,557,823,552,0.38968824940048,0,0,NA,NA,none,hothiphop.parents,hot.parents
2019,1,WCR2019_1560,1,WCR2019_0579,WCR2019_0405,within-group subordinate,within-group subordinate,3,0,3,2,1,2,1,1,99999,784,747,741,0.0531645569620253,0,0,NA,NA,none,hothiphop.parents,hot.parents
2019,1,WCR2019_1560,2,WCR2019_0252,WCR2019_0405,within-group subordinate,within-group subordinate,4,1,3,2,1,3,2,1,99999,787,747,744,0.0531645569620253,0,0,NA,NA,none,hothiphop.parents,hot.parents
2019,1,WCR2019_1560,3,WCR2019_0252,WCR2019_0039,within-group subordinate,within-group subordinate,5,1,4,2,3,3,4,1,99999,787,768,765,0.0531645569620253,0,0,NA,NA,none,hothiphop.parents,hot.parents
2019,1,WCR2019_1562,1,WCR2019_0344,WCR2019_0313,within-group subordinate,within-group subordinate,2,0,2,0,2,0,2,1,99999,820,815,809,0.357142857142857,0,0,NA,NA,none,hothiphop.parents,hot.parents
2019,1,WCR2019_1562,2,WCR2019_0223,WCR2019_0313,within-group subordinate,within-group subordinate,45,22,23,21,2,43,24,1,99999,468,815,465,0.357142857142857,0,0,NA,NA,none,hothiphop.parents,hot.parents
2019,1,WCR2019_1562,3,WCR2019_0344,WCR2019_0327,within-group subordinate,within-group subordinate,49,37,12,0,12,37,49,1,99999,820,796,790,0.357142857142857,0,0,NA,NA,none,hothiphop.parents,hot.parents
2019,1,WCR2019_1564,1,WCR2019_0223,WCR2019_0061,within-group subordinate,within-group subordinate,57,36,21,23,9,59,45,1,99999,462,724,403,0.413708690330477,0,0,NA,NA,none,hothiphop.parents,hot.parents
2019,1,WCR2019_1564,2,WCR2019_0223,WCR2019_0088,within-group subordinate,within-group subordinate,57,28,29,23,22,51,50,1,99999,462,621,366,0.413708690330477,0,0,NA,NA,none,hothiphop.parents,hot.parents
2019,1,WCR2019_1564,3,WCR2019_0223,WCR2019_0327,within-group subordinate,within-group subordinate,58,28,30,23,17,51,45,1,99999,462,788,447,0.413708690330477,0,0,NA,NA,none,hothiphop.parents,hot.parents
2019,1,WCR2019_1565,1,WCR2019_0333,WCR2019_0537,within-group subordinate,within-group subordinate,6,3,3,2,2,5,5,1,99999,798,803,794,0.313506815365551,0,0,NA,NA,none,hothiphop.parents,hot.parents
2019,1,WCR2019_1565,2,WCR2019_0334,WCR2019_0537,within-group subordinate,within-group subordinate,7,4,3,1,2,5,6,1,99999,804,803,801,0.313506815365551,0,0,NA,NA,none,hothiphop.parents,hot.parents
2019,1,WCR2019_1565,3,WCR2019_0217,WCR2019_0537,within-group subordinate,within-group subordinate,7,2,5,5,2,7,4,1,99999,795,803,791,0.313506815365551,0,0,NA,NA,none,hothiphop.parents,hot.parents
2019,1,WCR2019_1566,1,WCR2019_0334,WCR2019_0405,within-group subordinate,within-group subordinate,3,3,0,0,0,3,3,1,99999,693,657,654,0.0704022988505747,0,0,NA,NA,none,hothiphop.parents,hot.parents
2019,1,WCR2019_1566,2,WCR2019_0119,WCR2019_0405,within-group subordinate,within-group subordinate,3,2,1,2,0,4,2,1,99999,696,657,657,0.0704022988505747,0,0,NA,NA,none,hothiphop.parents,hot.parents
2019,1,WCR2019_1566,3,WCR2019_0579,WCR2019_0405,within-group subordinate,within-group subordinate,3,2,1,2,0,4,2,1,99999,690,657,651,0.0704022988505747,0,0,NA,NA,none,hothiphop.parents,hot.parents
2019,1,WCR2019_1567,1,WCR2019_0223,WCR2019_0087,within-group subordinate,within-group subordinate,51,15,36,26,32,41,47,1,99999,481,620,351,0.361601884570082,0,0,NA,NA,none,hothiphop.parents,hot.parents
2019,1,WCR2019_1567,2,WCR2019_0440,WCR2019_0087,within-group subordinate,within-group subordinate,55,16,39,26,32,42,48,1,99999,560,620,407,0.361601884570082,0,0,NA,NA,none,hothiphop.parents,hot.parents
2019,1,WCR2019_1567,3,WCR2019_0223,WCR2019_0061,within-group subordinate,within-group subordinate,71,30,41,26,41,56,71,1,99999,481,755,422,0.361601884570082,0,0,NA,NA,none,hothiphop.parents,hot.parents
2019,1,WCR2019_1568,1,WCR2019_0256,WCR2019_0047,within-group subordinate,within-group subordinate,4,1,3,1,3,2,4,1,99999,774,776,773,0.294723294723295,0,0,NA,NA,none,hothiphop.parents,hot.parents
2019,1,WCR2019_1568,2,WCR2019_0489,WCR2019_0047,within-group subordinate,within-group subordinate,5,1,4,1,3,2,4,1,99999,776,776,775,0.294723294723295,0,0,NA,NA,none,hothiphop.parents,hot.parents
2019,1,WCR2019_1568,3,WCR2019_0409,WCR2019_0047,within-group subordinate,within-group subordinate,6,2,4,1,3,3,5,1,99999,772,776,771,0.294723294723295,0,0,NA,NA,none,hothiphop.parents,hot.parents
2019,1,WCR2019_1569,1,WCR2019_0223,WCR2019_0327,within-group subordinate,within-group subordinate,45,23,22,20,12,43,35,1,99999,481,812,466,0.389548693586698,0,0,NA,NA,none,hothiphop.parents,hot.parents
2019,1,WCR2019_1569,2,WCR2019_0214,WCR2019_0327,within-group subordinate,within-group subordinate,46,34,12,1,12,35,46,1,99999,839,812,809,0.389548693586698,0,0,NA,NA,none,hothiphop.parents,hot.parents
2019,1,WCR2019_1569,3,WCR2019_0223,WCR2019_0075,within-group subordinate,within-group subordinate,51,28,23,20,33,48,61,1,99999,481,736,412,0.389548693586698,0,0,NA,NA,none,hothiphop.parents,hot.parents
2019,1,WCR2019_1570,1,WCR2019_0536,WCR2019_0463,within-group subordinate,within-group subordinate,1,1,0,0,0,1,1,1,99999,812,826,812,0.405569007263923,0,0,NA,NA,none,hothiphop.parents,hot.parents
2019,1,WCR2019_1570,2,WCR2019_0536,WCR2019_0327,within-group subordinate,within-group subordinate,48,33,15,0,16,33,49,1,99999,812,799,787,0.405569007263923,0,0,NA,NA,none,hothiphop.parents,hot.parents
2019,1,WCR2019_1570,3,WCR2019_0223,WCR2019_0327,within-group subordinate,within-group subordinate,49,26,23,19,16,45,42,1,99999,469,799,457,0.405569007263923,0,0,NA,NA,none,hothiphop.parents,hot.parents
2019,1,WCR2019_1571,1,WCR2019_0440,WCR2019_0243,within-group subordinate,within-group subordinate,55,25,30,30,0,55,25,1,99999,546,824,542,0.375750300120048,0,0,NA,NA,none,hothiphop.parents,hot.parents
2019,1,WCR2019_1571,2,WCR2019_0223,WCR2019_0243,within-group subordinate,within-group subordinate,57,28,29,29,0,57,28,1,99999,475,824,473,0.375750300120048,0,0,NA,NA,none,hothiphop.parents,hot.parents
2019,1,WCR2019_1571,3,WCR2019_0223,WCR2019_0087,within-group subordinate,within-group subordinate,63,30,33,29,37,59,67,1,99999,475,611,347,0.375750300120048,0,0,NA,NA,none,hothiphop.parents,hot.parents
2019,1,WCR2019_1573,1,WCR2019_0223,WCR2019_0088,within-group subordinate,within-group subordinate,46,31,15,11,17,42,48,1,99999,427,573,336,0.462050599201065,0,0,NA,NA,none,hothiphop.parents,hot.parents
2019,1,WCR2019_1573,2,WCR2019_0223,WCR2019_0122,within-group subordinate,within-group subordinate,49,31,18,11,14,42,45,1,99999,427,741,422,0.462050599201065,0,0,NA,NA,none,hothiphop.parents,hot.parents
2019,1,WCR2019_1573,3,WCR2019_0223,WCR2019_0327,within-group subordinate,within-group subordinate,51,35,16,11,9,46,44,1,99999,427,725,414,0.462050599201065,0,0,NA,NA,none,hothiphop.parents,hot.parents
2019,1,WCR2019_1574,1,WCR2019_0223,WCR2019_0537,within-group subordinate,within-group subordinate,34,19,15,12,15,31,34,1,99999,463,802,462,0.379353233830846,0,0,NA,NA,none,hothiphop.parents,hot.parents
2019,1,WCR2019_1574,2,WCR2019_0223,WCR2019_0327,within-group subordinate,within-group subordinate,35,16,19,12,13,28,29,1,99999,463,777,450,0.379353233830846,0,0,NA,NA,none,hothiphop.parents,hot.parents
2019,1,WCR2019_1574,3,WCR2019_0223,WCR2019_0075,within-group subordinate,within-group subordinate,37,21,16,12,22,33,43,1,99999,463,704,398,0.379353233830846,0,0,NA,NA,none,hothiphop.parents,hot.parents
2019,1,WCR2019_1575,1,WCR2019_0440,WCR2019_0122,within-group subordinate,within-group subordinate,47,25,22,17,15,42,40,1,99999,560,834,554,0.407801418439716,0,0,NA,NA,none,hothiphop.parents,hot.parents
2019,1,WCR2019_1575,2,WCR2019_0440,WCR2019_0327,within-group subordinate,within-group subordinate,51,31,20,17,17,48,48,1,99999,560,815,540,0.407801418439716,0,0,NA,NA,none,hothiphop.parents,hot.parents
2019,1,WCR2019_1575,3,WCR2019_0223,WCR2019_0161,within-group subordinate,within-group subordinate,54,30,24,20,19,50,49,1,99999,481,796,462,0.407801418439716,0,0,NA,NA,none,hothiphop.parents,hot.parents
2019,1,WCR2019_1626,1,WCR2019_0223,WCR2019_0087,within-group subordinate,within-group subordinate,53,17,36,23,46,40,63,1,99999,459,595,339,0.40818858560794,0,0,NA,NA,none,hothiphop.parents,hot.parents
2019,1,WCR2019_1626,2,WCR2019_0223,WCR2019_0327,within-group subordinate,within-group subordinate,65,33,32,23,31,56,64,1,99999,459,778,445,0.40818858560794,0,0,NA,NA,none,hothiphop.parents,hot.parents
2019,1,WCR2019_1626,3,WCR2019_0223,WCR2019_0075,within-group subordinate,within-group subordinate,71,35,36,23,50,58,85,1,99999,459,706,394,0.40818858560794,0,0,NA,NA,none,hothiphop.parents,hot.parents
2019,1,WCR2019_1634,1,WCR2019_0420,WCR2019_0325,within-group subordinate,within-group subordinate,0,0,0,0,0,0,0,1,99999,835,827,826,0.143540669856459,0,0,NA,NA,none,hothiphop.parents,hot.parents
2019,1,WCR2019_1634,2,WCR2019_0474,WCR2019_0325,within-group subordinate,within-group subordinate,3,1,2,2,0,3,1,1,99999,716,827,709,0.143540669856459,0,0,NA,NA,none,hothiphop.parents,hot.parents
2019,1,WCR2019_1634,3,WCR2019_0252,WCR2019_0325,within-group subordinate,within-group subordinate,5,1,4,4,0,5,1,1,99999,833,827,824,0.143540669856459,0,0,NA,NA,none,hothiphop.parents,hot.parents
2019,1,WCR2019_1635,1,WCR2019_0223,WCR2019_0327,within-group subordinate,within-group subordinate,41,29,12,9,6,38,35,1,99999,435,742,421,0.496103896103896,0,0,NA,NA,none,hothiphop.parents,hot.parents
2019,1,WCR2019_1635,2,WCR2019_0223,WCR2019_0161,within-group subordinate,within-group subordinate,43,32,11,9,6,41,38,1,99999,435,725,417,0.496103896103896,0,0,NA,NA,none,hothiphop.parents,hot.parents
2019,1,WCR2019_1635,3,WCR2019_0223,WCR2019_0061,within-group subordinate,within-group subordinate,43,31,12,9,15,40,46,1,99999,435,688,385,0.496103896103896,0,0,NA,NA,none,hothiphop.parents,hot.parents
2019,1,WCR2019_1636,1,WCR2019_0223,WCR2019_0088,within-group subordinate,within-group subordinate,37,17,20,24,1,41,18,1,99999,478,635,374,0.354685646500593,0,0,NA,NA,none,hothiphop.parents,hot.parents
2019,1,WCR2019_1636,2,WCR2019_0440,WCR2019_0122,within-group subordinate,within-group subordinate,40,16,24,23,3,39,19,1,99999,561,831,555,0.354685646500593,0,0,NA,NA,none,hothiphop.parents,hot.parents
2019,1,WCR2019_1636,3,WCR2019_0223,WCR2019_0327,within-group subordinate,within-group subordinate,42,16,26,24,7,40,23,1,99999,478,812,463,0.354685646500593,0,0,NA,NA,none,hothiphop.parents,hot.parents
2019,1,WCR2019_1638,1,WCR2019_0440,WCR2019_0122,within-group subordinate,within-group subordinate,23,13,10,10,3,23,16,1,99999,519,768,513,0.469230769230769,0,0,NA,NA,none,hothiphop.parents,hot.parents
2019,1,WCR2019_1638,2,WCR2019_0223,WCR2019_0088,within-group subordinate,within-group subordinate,32,22,10,14,3,36,25,1,99999,441,603,353,0.469230769230769,0,0,NA,NA,none,hothiphop.parents,hot.parents
2019,1,WCR2019_1638,3,WCR2019_0440,WCR2019_0327,within-group subordinate,within-group subordinate,33,23,10,10,2,33,25,1,99999,519,752,500,0.469230769230769,0,0,NA,NA,none,hothiphop.parents,hot.parents
2019,1,WCR2019_1639,1,WCR2019_0223,WCR2019_0088,within-group subordinate,within-group subordinate,33,16,17,21,2,37,18,1,99999,480,636,374,0.365997638724911,0,0,NA,NA,none,hothiphop.parents,hot.parents
2019,1,WCR2019_1639,2,WCR2019_0287,WCR2019_0122,within-group subordinate,within-group subordinate,41,36,5,2,5,38,41,1,99999,840,835,828,0.365997638724911,0,0,NA,NA,none,hothiphop.parents,hot.parents
2019,1,WCR2019_1639,3,WCR2019_0287,WCR2019_0327,within-group subordinate,within-group subordinate,42,36,6,2,6,38,42,1,99999,840,817,813,0.365997638724911,0,0,NA,NA,none,hothiphop.parents,hot.parents
2019,1,WCR2019_1640,1,WCR2019_0223,WCR2019_0088,within-group subordinate,within-group subordinate,32,22,10,13,1,35,23,1,99999,473,631,372,0.468523002421308,0,0,NA,NA,none,hothiphop.parents,hot.parents
2019,1,WCR2019_1640,2,WCR2019_0191,WCR2019_0088,within-group subordinate,within-group subordinate,38,26,12,14,1,40,27,1,99999,624,631,465,0.468523002421308,0,0,NA,NA,none,hothiphop.parents,hot.parents
2019,1,WCR2019_1640,3,WCR2019_0223,WCR2019_0122,within-group subordinate,within-group subordinate,38,24,14,13,1,37,25,1,99999,473,814,466,0.468523002421308,0,0,NA,NA,none,hothiphop.parents,hot.parents
2019,1,WCR2019_1641,1,WCR2019_0420,WCR2019_0325,within-group subordinate,within-group subordinate,2,1,1,1,0,2,1,1,99999,822,814,813,0.100850546780073,0,0,NA,NA,none,hothiphop.parents,hot.parents
2019,1,WCR2019_1641,2,WCR2019_0474,WCR2019_0325,within-group subordinate,within-group subordinate,3,1,2,2,0,3,1,1,99999,704,814,697,0.100850546780073,0,0,NA,NA,none,hothiphop.parents,hot.parents
2019,1,WCR2019_1641,3,WCR2019_0252,WCR2019_0325,within-group subordinate,within-group subordinate,4,1,3,3,0,4,1,1,99999,821,814,812,0.100850546780073,0,0,NA,NA,none,hothiphop.parents,hot.parents
2019,1,WCR2019_1642,1,WCR2019_0223,WCR2019_0327,within-group subordinate,within-group subordinate,47,26,21,16,8,42,34,1,99999,451,758,438,0.44910941475827,0,0,NA,NA,none,hothiphop.parents,hot.parents
2019,1,WCR2019_1642,2,WCR2019_0223,WCR2019_0285,within-group subordinate,within-group subordinate,50,34,16,16,3,50,37,1,99999,451,780,450,0.44910941475827,0,0,NA,NA,none,hothiphop.parents,hot.parents
2019,1,WCR2019_1642,3,WCR2019_0223,WCR2019_0061,within-group subordinate,within-group subordinate,50,31,19,16,16,47,47,1,99999,451,702,394,0.44910941475827,0,0,NA,NA,none,hothiphop.parents,hot.parents
2019,1,WCR2019_1643,1,WCR2019_0223,WCR2019_0087,within-group subordinate,within-group subordinate,60,16,44,26,53,42,69,1,99999,483,621,353,0.313238770685579,0,0,NA,NA,none,hothiphop.parents,hot.parents
2019,1,WCR2019_1643,2,WCR2019_0223,WCR2019_0122,within-group subordinate,within-group subordinate,69,27,42,26,43,53,70,1,99999,483,834,476,0.313238770685579,0,0,NA,NA,none,hothiphop.parents,hot.parents
2019,1,WCR2019_1643,3,WCR2019_0223,WCR2019_0327,within-group subordinate,within-group subordinate,69,26,43,26,43,52,69,1,99999,483,816,468,0.313238770685579,0,0,NA,NA,none,hothiphop.parents,hot.parents
2019,1,WCR2019_1644,1,WCR2019_0223,WCR2019_0087,within-group subordinate,within-group subordinate,55,24,31,34,37,58,61,1,99999,478,619,352,0.366983372921615,0,0,NA,NA,none,hothiphop.parents,hot.parents
2019,1,WCR2019_1644,2,WCR2019_0440,WCR2019_0087,within-group subordinate,within-group subordinate,69,27,42,33,37,60,64,1,99999,557,619,409,0.366983372921615,0,0,NA,NA,none,hothiphop.parents,hot.parents
2019,1,WCR2019_1644,3,WCR2019_0223,WCR2019_0327,within-group subordinate,within-group subordinate,71,34,37,34,24,68,58,1,99999,478,811,463,0.366983372921615,0,0,NA,NA,none,hothiphop.parents,hot.parents
2019,1,WCR2019_1645,1,WCR2019_0252,WCR2019_0405,within-group subordinate,within-group subordinate,5,2,3,3,0,5,2,1,99999,834,788,785,0.0513739545997611,0,0,NA,NA,none,hothiphop.parents,hot.parents
2019,1,WCR2019_1645,2,WCR2019_0260,WCR2019_0405,within-group subordinate,within-group subordinate,5,2,3,4,0,6,2,1,99999,825,788,776,0.0513739545997611,0,0,NA,NA,none,hothiphop.parents,hot.parents
2019,1,WCR2019_1645,3,WCR2019_0474,WCR2019_0405,within-group subordinate,within-group subordinate,5,2,3,4,0,6,2,1,99999,718,788,676,0.0513739545997611,0,0,NA,NA,none,hothiphop.parents,hot.parents
2019,1,WCR2019_1646,1,WCR2019_0223,WCR2019_0122,within-group subordinate,within-group subordinate,47,23,24,16,22,39,45,1,99999,482,839,475,0.430082256169213,0,0,NA,NA,none,hothiphop.parents,hot.parents
2019,1,WCR2019_1646,2,WCR2019_0223,WCR2019_0161,within-group subordinate,within-group subordinate,50,28,22,16,19,44,47,1,99999,482,802,463,0.430082256169213,0,0,NA,NA,none,hothiphop.parents,hot.parents
2019,1,WCR2019_1646,3,WCR2019_0223,WCR2019_0327,within-group subordinate,within-group subordinate,53,27,26,16,21,43,48,1,99999,482,821,467,0.430082256169213,0,0,NA,NA,none,hothiphop.parents,hot.parents
2019,1,WCR2019_1647,1,WCR2019_0223,WCR2019_0061,within-group subordinate,within-group subordinate,54,25,29,22,35,47,60,1,99999,481,753,421,0.371462264150943,0,0,NA,NA,none,hothiphop.parents,hot.parents
2019,1,WCR2019_1647,2,WCR2019_0223,WCR2019_0161,within-group subordinate,within-group subordinate,55,27,28,22,28,49,55,1,99999,481,798,462,0.371462264150943,0,0,NA,NA,none,hothiphop.parents,hot.parents
2019,1,WCR2019_1647,3,WCR2019_0223,WCR2019_0327,within-group subordinate,within-group subordinate,58,31,27,22,21,53,52,1,99999,481,817,466,0.371462264150943,0,0,NA,NA,none,hothiphop.parents,hot.parents
2019,1,WCR2019_1648,1,WCR2019_0223,WCR2019_0088,within-group subordinate,within-group subordinate,47,24,23,15,20,39,44,1,99999,480,637,376,0.414893617021277,0,0,NA,NA,none,hothiphop.parents,hot.parents
2019,1,WCR2019_1648,2,WCR2019_0223,WCR2019_0327,within-group subordinate,within-group subordinate,48,27,21,15,11,42,38,1,99999,480,815,465,0.414893617021277,0,0,NA,NA,none,hothiphop.parents,hot.parents
2019,1,WCR2019_1648,3,WCR2019_0223,WCR2019_0075,within-group subordinate,within-group subordinate,50,32,18,15,19,47,51,1,99999,480,737,411,0.414893617021277,0,0,NA,NA,none,hothiphop.parents,hot.parents
2019,1,WCR2019_1649,1,WCR2019_0223,WCR2019_0088,within-group subordinate,within-group subordinate,41,16,25,28,15,44,31,1,99999,455,616,358,0.316377171215881,0,0,NA,NA,none,hothiphop.parents,hot.parents
2019,1,WCR2019_1649,2,WCR2019_0223,WCR2019_0327,within-group subordinate,within-group subordinate,44,13,31,28,13,41,26,1,99999,455,776,441,0.316377171215881,0,0,NA,NA,none,hothiphop.parents,hot.parents
2019,1,WCR2019_1649,3,WCR2019_0223,WCR2019_0061,within-group subordinate,within-group subordinate,48,20,28,28,29,48,49,1,99999,455,720,400,0.316377171215881,0,0,NA,NA,none,hothiphop.parents,hot.parents
2019,1,WCR2019_1650,1,WCR2019_0334,WCR2019_0519,within-group subordinate,within-group subordinate,4,4,0,0,0,4,4,1,99999,633,632,629,0.364779874213836,0,0,NA,NA,none,hothiphop.parents,hot.parents
2019,1,WCR2019_1650,2,WCR2019_0056,WCR2019_0519,within-group subordinate,within-group subordinate,4,3,1,1,0,4,3,1,99999,584,632,580,0.364779874213836,0,0,NA,NA,none,hothiphop.parents,hot.parents
2019,1,WCR2019_1650,3,WCR2019_0410,WCR2019_0519,within-group subordinate,within-group subordinate,4,3,1,1,0,4,3,1,99999,631,632,628,0.364779874213836,0,0,NA,NA,none,hothiphop.parents,hot.parents
2019,1,WCR2019_1651,1,WCR2019_0223,WCR2019_0087,within-group subordinate,within-group subordinate,65,29,36,26,44,55,73,1,99999,467,596,339,0.394160583941606,0,0,NA,NA,none,hothiphop.parents,hot.parents
2019,1,WCR2019_1651,2,WCR2019_0543,WCR2019_0122,within-group subordinate,within-group subordinate,69,36,33,1,32,37,68,1,99999,815,813,806,0.394160583941606,0,0,NA,NA,none,hothiphop.parents,hot.parents
2019,1,WCR2019_1651,3,WCR2019_0223,WCR2019_0061,within-group subordinate,within-group subordinate,69,33,36,26,46,59,79,1,99999,467,727,406,0.394160583941606,0,0,NA,NA,none,hothiphop.parents,hot.parents
2019,1,WCR2019_1652,1,WCR2019_0567,WCR2019_0066,within-group subordinate,within-group subordinate,4,1,3,2,1,3,2,1,99999,817,828,812,0.411764705882353,0,0,NA,NA,none,hothiphop.parents,hot.parents
2019,1,WCR2019_1652,2,WCR2019_0223,WCR2019_0066,within-group subordinate,within-group subordinate,48,22,26,25,1,47,23,1,99999,476,828,472,0.411764705882353,0,0,NA,NA,none,hothiphop.parents,hot.parents
2019,1,WCR2019_1652,3,WCR2019_0567,WCR2019_0327,within-group subordinate,within-group subordinate,53,29,24,2,25,31,54,1,99999,817,802,787,0.411764705882353,0,0,NA,NA,none,hothiphop.parents,hot.parents
2019,1,WCR2019_1653,1,WCR2019_0223,WCR2019_0327,within-group subordinate,within-group subordinate,61,31,30,24,25,55,56,1,99999,475,799,460,0.38433734939759,0,0,NA,NA,none,hothiphop.parents,hot.parents
2019,1,WCR2019_1653,2,WCR2019_0223,WCR2019_0087,within-group subordinate,within-group subordinate,64,26,38,24,45,50,71,1,99999,475,616,351,0.38433734939759,0,0,NA,NA,none,hothiphop.parents,hot.parents
2019,1,WCR2019_1653,3,WCR2019_0223,WCR2019_0061,within-group subordinate,within-group subordinate,66,30,36,24,43,54,73,1,99999,475,740,416,0.38433734939759,0,0,NA,NA,none,hothiphop.parents,hot.parents
2019,1,WCR2019_1654,1,WCR2019_0223,WCR2019_0088,within-group subordinate,within-group subordinate,35,19,16,21,2,40,21,1,99999,409,576,329,0.363636363636364,0,0,NA,NA,none,hothiphop.parents,hot.parents
2019,1,WCR2019_1654,2,WCR2019_0467,WCR2019_0327,within-group subordinate,within-group subordinate,37,31,6,3,5,34,36,1,99999,737,710,710,0.363636363636364,0,0,NA,NA,none,hothiphop.parents,hot.parents
2019,1,WCR2019_1654,3,WCR2019_0344,WCR2019_0327,within-group subordinate,within-group subordinate,37,30,7,5,5,35,35,1,99999,730,710,703,0.363636363636364,0,0,NA,NA,none,hothiphop.parents,hot.parents
2019,1,WCR2019_1655,1,WCR2019_0357,WCR2019_0327,within-group subordinate,within-group subordinate,51,30,21,3,18,33,48,1,99999,848,818,817,0.382803297997644,0,0,NA,NA,none,hothiphop.parents,hot.parents
2019,1,WCR2019_1655,2,WCR2019_0223,WCR2019_0087,within-group subordinate,within-group subordinate,66,27,39,31,48,58,75,1,99999,484,620,353,0.382803297997644,0,0,NA,NA,none,hothiphop.parents,hot.parents
2019,1,WCR2019_1655,3,WCR2019_0357,WCR2019_0122,within-group subordinate,within-group subordinate,67,32,35,3,32,35,64,1,99999,848,838,837,0.382803297997644,0,0,NA,NA,none,hothiphop.parents,hot.parents
2019,1,WCR2019_1656,1,WCR2019_0440,WCR2019_0327,within-group subordinate,within-group subordinate,38,19,19,17,5,36,24,1,99999,526,771,509,0.413016270337922,0,0,NA,NA,none,hothiphop.parents,hot.parents
2019,1,WCR2019_1656,2,WCR2019_0440,WCR2019_0122,within-group subordinate,within-group subordinate,42,18,24,17,10,35,28,1,99999,526,787,520,0.413016270337922,0,0,NA,NA,none,hothiphop.parents,hot.parents
2019,1,WCR2019_1656,3,WCR2019_0267,WCR2019_0327,within-group subordinate,within-group subordinate,44,38,6,2,5,40,43,1,99999,785,771,759,0.413016270337922,0,0,NA,NA,none,hothiphop.parents,hot.parents
2019,1,WCR2019_1657,1,WCR2019_0223,WCR2019_0087,within-group subordinate,within-group subordinate,53,16,37,24,42,40,58,1,99999,486,622,354,0.387587822014052,0,0,NA,NA,none,hothiphop.parents,hot.parents
2019,1,WCR2019_1657,2,WCR2019_0223,WCR2019_0327,within-group subordinate,within-group subordinate,56,26,30,24,27,50,53,1,99999,486,823,471,0.387587822014052,0,0,NA,NA,none,hothiphop.parents,hot.parents
2019,1,WCR2019_1657,3,WCR2019_0223,WCR2019_0061,within-group subordinate,within-group subordinate,58,22,36,24,42,46,64,1,99999,486,756,423,0.387587822014052,0,0,NA,NA,none,hothiphop.parents,hot.parents
2019,1,WCR2019_1658,1,WCR2019_0223,WCR2019_0407,within-group subordinate,within-group subordinate,47,31,16,16,1,47,32,1,99999,482,844,478,0.434117647058824,0,0,NA,NA,none,hothiphop.parents,hot.parents
2019,1,WCR2019_1658,2,WCR2019_0223,WCR2019_0327,within-group subordinate,within-group subordinate,50,30,20,16,14,46,44,1,99999,482,819,467,0.434117647058824,0,0,NA,NA,none,hothiphop.parents,hot.parents
2019,1,WCR2019_1658,3,WCR2019_0223,WCR2019_0161,within-group subordinate,within-group subordinate,54,32,22,16,16,48,48,1,99999,482,800,463,0.434117647058824,0,0,NA,NA,none,hothiphop.parents,hot.parents
2019,1,WCR2019_1659,1,WCR2019_0223,WCR2019_0088,within-group subordinate,within-group subordinate,54,27,27,22,30,49,57,1,99999,482,640,376,0.392018779342723,0,0,NA,NA,none,hothiphop.parents,hot.parents
2019,1,WCR2019_1659,2,WCR2019_0440,WCR2019_0122,within-group subordinate,within-group subordinate,55,22,33,28,19,50,41,1,99999,566,841,560,0.392018779342723,0,0,NA,NA,none,hothiphop.parents,hot.parents
2019,1,WCR2019_1659,3,WCR2019_0223,WCR2019_0327,within-group subordinate,within-group subordinate,57,31,26,22,13,53,44,1,99999,482,821,467,0.392018779342723,0,0,NA,NA,none,hothiphop.parents,hot.parents
2019,1,WCR2019_1660,1,WCR2019_0428,WCR2019_0327,within-group subordinate,within-group subordinate,47,31,16,1,15,32,46,1,99999,856,826,825,0.413068844807468,0,0,NA,NA,none,hothiphop.parents,hot.parents
2019,1,WCR2019_1660,2,WCR2019_0223,WCR2019_0327,within-group subordinate,within-group subordinate,53,32,21,15,15,47,47,1,99999,488,826,473,0.413068844807468,0,0,NA,NA,none,hothiphop.parents,hot.parents
2019,1,WCR2019_1660,3,WCR2019_0223,WCR2019_0088,within-group subordinate,within-group subordinate,57,29,28,15,36,44,65,1,99999,488,645,381,0.413068844807468,0,0,NA,NA,none,hothiphop.parents,hot.parents
2019,1,WCR2019_1661,1,WCR2019_0223,WCR2019_0061,within-group subordinate,within-group subordinate,58,29,29,27,23,56,52,1,99999,473,738,413,0.399759903961585,0,0,NA,NA,none,hothiphop.parents,hot.parents
2019,1,WCR2019_1661,2,WCR2019_0223,WCR2019_0088,within-group subordinate,within-group subordinate,60,26,34,27,23,53,49,1,99999,473,628,369,0.399759903961585,0,0,NA,NA,none,hothiphop.parents,hot.parents
2019,1,WCR2019_1661,3,WCR2019_0223,WCR2019_0327,within-group subordinate,within-group subordinate,62,31,31,27,11,58,42,1,99999,473,802,458,0.399759903961585,0,0,NA,NA,none,hothiphop.parents,hot.parents
2019,1,WCR2019_1662,1,WCR2019_0223,WCR2019_0327,within-group subordinate,within-group subordinate,42,26,16,15,9,41,35,1,99999,380,644,368,0.48729446935725,0,0,NA,NA,none,hothiphop.parents,hot.parents
2019,1,WCR2019_1662,2,WCR2019_0440,WCR2019_0122,within-group subordinate,within-group subordinate,42,23,19,13,10,36,33,1,99999,453,662,450,0.48729446935725,0,0,NA,NA,none,hothiphop.parents,hot.parents
2019,1,WCR2019_1662,3,WCR2019_0223,WCR2019_0061,within-group subordinate,within-group subordinate,43,25,18,15,17,40,42,1,99999,380,594,332,0.48729446935725,0,0,NA,NA,none,hothiphop.parents,hot.parents
2019,1,WCR2019_1663,1,WCR2019_0252,WCR2019_0157,within-group subordinate,within-group subordinate,8,4,4,3,3,7,7,1,99999,825,821,818,0.0603864734299517,0,0,NA,NA,none,hothiphop.parents,hot.parents
2019,1,WCR2019_1663,2,WCR2019_0474,WCR2019_0451,within-group subordinate,within-group subordinate,8,1,7,5,7,6,8,1,99999,712,825,710,0.0603864734299517,0,0,NA,NA,none,hothiphop.parents,hot.parents
2019,1,WCR2019_1663,3,WCR2019_0334,WCR2019_0157,within-group subordinate,within-group subordinate,10,6,4,3,3,9,9,1,99999,825,821,818,0.0603864734299517,0,0,NA,NA,none,hothiphop.parents,hot.parents
2019,1,WCR2019_1664,1,WCR2019_0223,WCR2019_0088,within-group subordinate,within-group subordinate,49,26,23,14,27,40,53,1,99999,382,520,299,0.414348462664714,0,0,NA,NA,none,hothiphop.parents,hot.parents
2019,1,WCR2019_1664,2,WCR2019_0223,WCR2019_0087,within-group subordinate,within-group subordinate,49,22,27,14,36,36,58,1,99999,382,496,280,0.414348462664714,0,0,NA,NA,none,hothiphop.parents,hot.parents
2019,1,WCR2019_1664,3,WCR2019_0223,WCR2019_0075,within-group subordinate,within-group subordinate,51,28,23,14,26,42,54,1,99999,382,598,329,0.414348462664714,0,0,NA,NA,none,hothiphop.parents,hot.parents
2019,1,WCR2019_1665,1,WCR2019_0223,WCR2019_0087,within-group subordinate,within-group subordinate,48,17,31,25,34,42,51,1,99999,468,610,343,0.386281588447653,0,0,NA,NA,none,hothiphop.parents,hot.parents
2019,1,WCR2019_1665,2,WCR2019_0223,WCR2019_0122,within-group subordinate,within-group subordinate,61,27,34,25,30,52,57,1,99999,468,821,462,0.386281588447653,0,0,NA,NA,none,hothiphop.parents,hot.parents
2019,1,WCR2019_1665,3,WCR2019_0223,WCR2019_0073,within-group subordinate,within-group subordinate,61,19,42,25,45,44,64,1,99999,468,764,421,0.386281588447653,0,0,NA,NA,none,hothiphop.parents,hot.parents
2019,1,WCR2019_1666,1,WCR2019_0223,WCR2019_0161,within-group subordinate,within-group subordinate,39,27,12,11,9,38,36,1,99999,426,717,408,0.463254593175853,0,0,NA,NA,none,hothiphop.parents,hot.parents
2019,1,WCR2019_1666,2,WCR2019_0223,WCR2019_0327,within-group subordinate,within-group subordinate,42,23,19,11,12,34,35,1,99999,426,733,412,0.463254593175853,0,0,NA,NA,none,hothiphop.parents,hot.parents
2019,1,WCR2019_1666,3,WCR2019_0468,WCR2019_0124,within-group subordinate,within-group subordinate,44,21,23,1,22,22,43,1,99999,762,759,759,0.463254593175853,0,0,NA,NA,none,hothiphop.parents,hot.parents
2019,1,WCR2019_1667,1,WCR2019_0223,WCR2019_0161,within-group subordinate,within-group subordinate,53,23,30,20,25,43,48,1,99999,474,789,455,0.366348448687351,0,0,NA,NA,none,hothiphop.parents,hot.parents
2019,1,WCR2019_1667,2,WCR2019_0223,WCR2019_0327,within-group subordinate,within-group subordinate,55,25,30,20,21,45,46,1,99999,474,807,459,0.366348448687351,0,0,NA,NA,none,hothiphop.parents,hot.parents
2019,1,WCR2019_1667,3,WCR2019_0223,WCR2019_0087,within-group subordinate,within-group subordinate,56,21,35,20,45,41,66,1,99999,474,613,347,0.366348448687351,0,0,NA,NA,none,hothiphop.parents,hot.parents
2019,1,WCR2019_1668,1,WCR2019_0440,WCR2019_0122,within-group subordinate,within-group subordinate,33,17,16,14,3,31,20,1,99999,537,799,531,0.478421701602959,0,0,NA,NA,none,hothiphop.parents,hot.parents
2019,1,WCR2019_1668,2,WCR2019_0223,WCR2019_0088,within-group subordinate,within-group subordinate,37,27,10,13,3,40,30,1,99999,459,618,363,0.478421701602959,0,0,NA,NA,none,hothiphop.parents,hot.parents
2019,1,WCR2019_1668,3,WCR2019_0223,WCR2019_0061,within-group subordinate,within-group subordinate,40,29,11,13,10,42,39,1,99999,459,723,403,0.478421701602959,0,0,NA,NA,none,hothiphop.parents,hot.parents
2019,1,WCR2019_1669,1,WCR2019_0440,WCR2019_0327,within-group subordinate,within-group subordinate,37,22,15,13,5,35,27,1,99999,536,783,517,0.444034440344403,0,0,NA,NA,none,hothiphop.parents,hot.parents
2019,1,WCR2019_1669,2,WCR2019_0223,WCR2019_0088,within-group subordinate,within-group subordinate,45,27,18,19,15,46,42,1,99999,458,613,358,0.444034440344403,0,0,NA,NA,none,hothiphop.parents,hot.parents
2019,1,WCR2019_1669,3,WCR2019_0440,WCR2019_0088,within-group subordinate,within-group subordinate,49,31,18,13,15,44,46,1,99999,536,613,408,0.444034440344403,0,0,NA,NA,none,hothiphop.parents,hot.parents
2019,1,WCR2019_1670,1,WCR2019_0223,WCR2019_0161,within-group subordinate,within-group subordinate,42,22,20,17,30,39,52,1,99999,482,793,463,0.377672209026128,0,0,NA,NA,none,hothiphop.parents,hot.parents
2019,1,WCR2019_1670,2,WCR2019_0223,WCR2019_0075,within-group subordinate,within-group subordinate,46,25,21,17,29,42,54,1,99999,482,735,413,0.377672209026128,0,0,NA,NA,none,hothiphop.parents,hot.parents
2019,1,WCR2019_1670,3,WCR2019_0223,WCR2019_0327,within-group subordinate,within-group subordinate,46,23,23,17,17,40,40,1,99999,482,812,467,0.377672209026128,0,0,NA,NA,none,hothiphop.parents,hot.parents
2019,1,WCR2019_1672,1,WCR2019_0223,WCR2019_0161,within-group subordinate,within-group subordinate,50,28,22,22,21,50,49,1,99999,487,806,468,0.428738317757009,0,0,NA,NA,none,hothiphop.parents,hot.parents
2019,1,WCR2019_1672,2,WCR2019_0223,WCR2019_0327,within-group subordinate,within-group subordinate,54,30,24,22,12,52,42,1,99999,487,825,472,0.428738317757009,0,0,NA,NA,none,hothiphop.parents,hot.parents
2019,1,WCR2019_1672,3,WCR2019_0223,WCR2019_0061,within-group subordinate,within-group subordinate,54,24,30,22,34,46,58,1,99999,487,758,424,0.428738317757009,0,0,NA,NA,none,hothiphop.parents,hot.parents
2019,1,WCR2019_1673,1,WCR2019_0223,WCR2019_0327,within-group subordinate,within-group subordinate,68,36,32,29,27,65,63,1,99999,478,816,464,0.368794326241135,0,0,NA,NA,none,hothiphop.parents,hot.parents
2019,1,WCR2019_1673,2,WCR2019_0223,WCR2019_0087,within-group subordinate,within-group subordinate,68,23,45,29,48,52,71,1,99999,478,618,349,0.368794326241135,0,0,NA,NA,none,hothiphop.parents,hot.parents
2019,1,WCR2019_1673,3,WCR2019_0223,WCR2019_0073,within-group subordinate,within-group subordinate,71,23,48,29,58,52,81,1,99999,478,777,430,0.368794326241135,0,0,NA,NA,none,hothiphop.parents,hot.parents
2019,1,WCR2019_1674,1,WCR2019_0223,WCR2019_0087,within-group subordinate,within-group subordinate,49,19,30,27,44,46,63,1,99999,485,621,353,0.401880141010576,0,0,NA,NA,none,hothiphop.parents,hot.parents
2019,1,WCR2019_1674,2,WCR2019_0223,WCR2019_0073,within-group subordinate,within-group subordinate,67,25,42,27,53,52,78,1,99999,485,779,434,0.401880141010576,0,0,NA,NA,none,hothiphop.parents,hot.parents
2019,1,WCR2019_1674,3,WCR2019_0440,WCR2019_0087,within-group subordinate,within-group subordinate,67,24,43,17,44,41,68,1,99999,566,621,412,0.401880141010576,0,0,NA,NA,none,hothiphop.parents,hot.parents
2019,1,WCR2019_1675,1,WCR2019_0223,WCR2019_0327,within-group subordinate,within-group subordinate,63,28,35,29,25,57,53,1,99999,485,825,470,0.368421052631579,0,0,NA,NA,none,hothiphop.parents,hot.parents
2019,1,WCR2019_1675,2,WCR2019_0223,WCR2019_0061,within-group subordinate,within-group subordinate,63,24,39,29,38,53,62,1,99999,485,759,423,0.368421052631579,0,0,NA,NA,none,hothiphop.parents,hot.parents
2019,1,WCR2019_1675,3,WCR2019_0223,WCR2019_0122,within-group subordinate,within-group subordinate,68,32,36,29,25,61,57,1,99999,485,843,478,0.368421052631579,0,0,NA,NA,none,hothiphop.parents,hot.parents
2019,1,WCR2019_1676,1,WCR2019_0223,WCR2019_0023,within-group subordinate,within-group subordinate,45,20,25,23,3,43,23,1,99999,486,850,484,0.380281690140845,0,0,NA,NA,none,hothiphop.parents,hot.parents
2019,1,WCR2019_1676,2,WCR2019_0223,WCR2019_0327,within-group subordinate,within-group subordinate,49,22,27,23,16,45,38,1,99999,486,822,471,0.380281690140845,0,0,NA,NA,none,hothiphop.parents,hot.parents
2019,1,WCR2019_1676,3,WCR2019_0223,WCR2019_0088,within-group subordinate,within-group subordinate,53,22,31,23,40,45,62,1,99999,486,643,380,0.380281690140845,0,0,NA,NA,none,hothiphop.parents,hot.parents
2019,1,WCR2019_1677,1,WCR2019_0223,WCR2019_0198,within-group subordinate,within-group subordinate,57,33,24,23,2,56,35,1,99999,484,840,481,0.372202591283863,0,0,NA,NA,none,hothiphop.parents,hot.parents
2019,1,WCR2019_1677,2,WCR2019_0440,WCR2019_0198,within-group subordinate,within-group subordinate,57,24,33,31,2,55,26,1,99999,560,840,555,0.372202591283863,0,0,NA,NA,none,hothiphop.parents,hot.parents
2019,1,WCR2019_1677,3,WCR2019_0440,WCR2019_0122,within-group subordinate,within-group subordinate,64,22,42,31,39,53,61,1,99999,560,837,554,0.372202591283863,0,0,NA,NA,none,hothiphop.parents,hot.parents
2019,1,WCR2019_1678,1,WCR2019_0223,WCR2019_0087,within-group subordinate,within-group subordinate,50,21,29,20,29,41,50,1,99999,482,622,352,0.407319952774498,0,0,NA,NA,none,hothiphop.parents,hot.parents
2019,1,WCR2019_1678,2,WCR2019_0223,WCR2019_0065,within-group subordinate,within-group subordinate,55,32,23,20,5,52,37,1,99999,482,843,481,0.407319952774498,0,0,NA,NA,none,hothiphop.parents,hot.parents
2019,1,WCR2019_1678,3,WCR2019_0223,WCR2019_0327,within-group subordinate,within-group subordinate,55,29,26,20,12,49,41,1,99999,482,816,467,0.407319952774498,0,0,NA,NA,none,hothiphop.parents,hot.parents
2019,1,WCR2019_1679,1,WCR2019_0223,WCR2019_0088,within-group subordinate,within-group subordinate,46,27,19,15,12,42,39,1,99999,484,641,378,0.496470588235294,0,0,NA,NA,none,hothiphop.parents,hot.parents
2019,1,WCR2019_1679,2,WCR2019_0223,WCR2019_0161,within-group subordinate,within-group subordinate,50,35,15,15,7,50,42,1,99999,484,800,465,0.496470588235294,0,0,NA,NA,none,hothiphop.parents,hot.parents
2019,1,WCR2019_1679,3,WCR2019_0440,WCR2019_0122,within-group subordinate,within-group subordinate,51,32,19,16,7,48,39,1,99999,562,838,556,0.496470588235294,0,0,NA,NA,none,hothiphop.parents,hot.parents
2019,1,WCR2019_1680,1,WCR2019_0223,WCR2019_0088,within-group subordinate,within-group subordinate,60,28,32,22,36,50,64,1,99999,481,640,375,0.394117647058824,0,0,NA,NA,none,hothiphop.parents,hot.parents
2019,1,WCR2019_1680,2,WCR2019_0223,WCR2019_0327,within-group subordinate,within-group subordinate,62,31,31,22,23,53,54,1,99999,481,819,466,0.394117647058824,0,0,NA,NA,none,hothiphop.parents,hot.parents
2019,1,WCR2019_1680,3,WCR2019_0223,WCR2019_0061,within-group subordinate,within-group subordinate,62,28,34,22,38,50,66,1,99999,481,753,419,0.394117647058824,0,0,NA,NA,none,hothiphop.parents,hot.parents
2019,1,WCR2019_1681,1,WCR2019_0440,WCR2019_0239,within-group subordinate,within-group subordinate,53,30,23,23,1,53,31,1,99999,565,848,561,0.373099415204678,0,0,NA,NA,none,hothiphop.parents,hot.parents
2019,1,WCR2019_1681,2,WCR2019_0223,WCR2019_0239,within-group subordinate,within-group subordinate,56,30,26,26,1,56,31,1,99999,485,848,484,0.373099415204678,0,0,NA,NA,none,hothiphop.parents,hot.parents
2019,1,WCR2019_1681,3,WCR2019_0223,WCR2019_0087,within-group subordinate,within-group subordinate,63,23,40,26,47,49,70,1,99999,485,625,354,0.373099415204678,0,0,NA,NA,none,hothiphop.parents,hot.parents
2019,1,WCR2019_1682,1,WCR2019_0223,WCR2019_0327,within-group subordinate,within-group subordinate,63,33,30,25,23,58,56,1,99999,487,822,472,0.430246189917937,0,0,NA,NA,none,hothiphop.parents,hot.parents
2019,1,WCR2019_1682,2,WCR2019_0223,WCR2019_0075,within-group subordinate,within-group subordinate,67,36,31,25,48,61,84,1,99999,487,744,417,0.430246189917937,0,0,NA,NA,none,hothiphop.parents,hot.parents
2019,1,WCR2019_1682,3,WCR2019_0223,WCR2019_0087,within-group subordinate,within-group subordinate,67,26,41,25,45,51,71,1,99999,487,622,354,0.430246189917937,0,0,NA,NA,none,hothiphop.parents,hot.parents
2019,1,WCR2019_1683,1,WCR2019_0223,WCR2019_0087,within-group subordinate,within-group subordinate,55,19,36,27,39,46,58,1,99999,488,626,356,0.366394399066511,0,0,NA,NA,none,hothiphop.parents,hot.parents
2019,1,WCR2019_1683,2,WCR2019_0223,WCR2019_0327,within-group subordinate,within-group subordinate,64,29,35,27,28,56,57,1,99999,488,826,473,0.366394399066511,0,0,NA,NA,none,hothiphop.parents,hot.parents
2019,1,WCR2019_1683,3,WCR2019_0223,WCR2019_0073,within-group subordinate,within-group subordinate,69,29,40,27,51,56,80,1,99999,488,785,437,0.366394399066511,0,0,NA,NA,none,hothiphop.parents,hot.parents
2019,1,WCR2019_1684,1,WCR2019_0530,WCR2019_0405,within-group subordinate,within-group subordinate,1,0,1,0,1,0,1,1,99999,853,805,804,0.226900584795322,0,0,NA,NA,none,hothiphop.parents,hot.parents
2019,1,WCR2019_1684,2,WCR2019_0530,WCR2019_0157,within-group subordinate,within-group subordinate,6,2,4,0,4,2,6,1,99999,853,849,847,0.226900584795322,0,0,NA,NA,none,hothiphop.parents,hot.parents
2019,1,WCR2019_1684,3,WCR2019_0530,WCR2019_0039,within-group subordinate,within-group subordinate,7,3,4,0,4,3,7,1,99999,853,833,831,0.226900584795322,0,0,NA,NA,none,hothiphop.parents,hot.parents
2019,1,WCR2019_1685,1,WCR2019_0223,WCR2019_0087,within-group subordinate,within-group subordinate,51,23,28,27,34,50,57,1,99999,477,615,347,0.39218009478673,0,0,NA,NA,none,hothiphop.parents,hot.parents
2019,1,WCR2019_1685,2,WCR2019_0223,WCR2019_0327,within-group subordinate,within-group subordinate,62,29,33,27,18,56,47,1,99999,477,813,462,0.39218009478673,0,0,NA,NA,none,hothiphop.parents,hot.parents
2019,1,WCR2019_1685,3,WCR2019_0223,WCR2019_0088,within-group subordinate,within-group subordinate,69,29,40,27,43,56,72,1,99999,477,633,372,0.39218009478673,0,0,NA,NA,none,hothiphop.parents,hot.parents
2019,1,WCR2019_1686,1,WCR2019_0223,WCR2019_0161,within-group subordinate,within-group subordinate,63,33,30,26,23,59,56,1,99999,487,807,468,0.400233372228705,0,0,NA,NA,none,hothiphop.parents,hot.parents
2019,1,WCR2019_1686,2,WCR2019_0440,WCR2019_0327,within-group subordinate,within-group subordinate,68,37,31,27,19,64,56,1,99999,567,826,547,0.400233372228705,0,0,NA,NA,none,hothiphop.parents,hot.parents
2019,1,WCR2019_1686,3,WCR2019_0223,WCR2019_0327,within-group subordinate,within-group subordinate,68,33,35,26,19,59,52,1,99999,487,826,472,0.400233372228705,0,0,NA,NA,none,hothiphop.parents,hot.parents
2019,1,WCR2019_1687,1,WCR2019_0223,WCR2019_0088,within-group subordinate,within-group subordinate,41,24,17,15,11,39,35,1,99999,417,565,327,0.459387483355526,0,0,NA,NA,none,hothiphop.parents,hot.parents
2019,1,WCR2019_1687,2,WCR2019_0223,WCR2019_0075,within-group subordinate,within-group subordinate,45,31,14,15,12,46,43,1,99999,417,655,354,0.459387483355526,0,0,NA,NA,none,hothiphop.parents,hot.parents
2019,1,WCR2019_1687,3,WCR2019_0223,WCR2019_0206,within-group subordinate,within-group subordinate,47,27,20,15,18,42,45,1,99999,417,739,414,0.459387483355526,0,0,NA,NA,none,hothiphop.parents,hot.parents
2019,1,WCR2019_1688,1,WCR2019_0223,WCR2019_0327,within-group subordinate,within-group subordinate,36,18,18,15,10,33,28,1,99999,396,675,384,0.42346208869814,0,0,NA,NA,none,hothiphop.parents,hot.parents
2019,1,WCR2019_1688,2,WCR2019_0223,WCR2019_0088,within-group subordinate,within-group subordinate,42,17,25,15,32,32,49,1,99999,396,540,312,0.42346208869814,0,0,NA,NA,none,hothiphop.parents,hot.parents
2019,1,WCR2019_1688,3,WCR2019_0223,WCR2019_0087,within-group subordinate,within-group subordinate,43,18,25,15,34,33,52,1,99999,396,521,291,0.42346208869814,0,0,NA,NA,none,hothiphop.parents,hot.parents
2019,1,WCR2019_1689,1,WCR2019_0223,WCR2019_0088,within-group subordinate,within-group subordinate,30,19,11,14,2,33,21,1,99999,448,594,352,0.498079385403329,0,0,NA,NA,none,hothiphop.parents,hot.parents
2019,1,WCR2019_1689,2,WCR2019_0440,WCR2019_0122,within-group subordinate,within-group subordinate,31,18,13,11,2,29,20,1,99999,524,770,519,0.498079385403329,0,0,NA,NA,none,hothiphop.parents,hot.parents
2019,1,WCR2019_1689,3,WCR2019_0223,WCR2019_0122,within-group subordinate,within-group subordinate,37,23,14,14,2,37,25,1,99999,448,770,442,0.498079385403329,0,0,NA,NA,none,hothiphop.parents,hot.parents
2019,1,WCR2019_1690,1,WCR2019_0223,WCR2019_0327,within-group subordinate,within-group subordinate,47,24,23,18,15,42,39,1,99999,451,756,439,0.435504469987229,0,0,NA,NA,none,hothiphop.parents,hot.parents
2019,1,WCR2019_1690,2,WCR2019_0223,WCR2019_0061,within-group subordinate,within-group subordinate,50,27,23,18,22,45,49,1,99999,451,695,393,0.435504469987229,0,0,NA,NA,none,hothiphop.parents,hot.parents
2019,1,WCR2019_1690,3,WCR2019_0223,WCR2019_0088,within-group subordinate,within-group subordinate,50,25,25,18,29,43,54,1,99999,451,588,355,0.435504469987229,0,0,NA,NA,none,hothiphop.parents,hot.parents
2019,1,WCR2019_1691,1,WCR2019_0440,WCR2019_0122,within-group subordinate,within-group subordinate,54,28,26,16,20,44,48,1,99999,511,764,506,0.423027166882277,0,0,NA,NA,none,hothiphop.parents,hot.parents
2019,1,WCR2019_1691,2,WCR2019_0223,WCR2019_0327,within-group subordinate,within-group subordinate,54,25,29,23,19,48,44,1,99999,441,744,427,0.423027166882277,0,0,NA,NA,none,hothiphop.parents,hot.parents
2019,1,WCR2019_1691,3,WCR2019_0440,WCR2019_0327,within-group subordinate,within-group subordinate,55,34,21,16,19,50,53,1,99999,511,744,492,0.423027166882277,0,0,NA,NA,none,hothiphop.parents,hot.parents
2019,1,WCR2019_1692,1,WCR2019_0223,WCR2019_0075,within-group subordinate,within-group subordinate,54,15,39,41,20,56,35,1,99999,485,740,415,0.249705535924617,0,0,NA,NA,none,hothiphop.parents,hot.parents
2019,1,WCR2019_1692,2,WCR2019_0223,WCR2019_0327,within-group subordinate,within-group subordinate,55,13,42,41,12,54,25,1,99999,485,818,470,0.249705535924617,0,0,NA,NA,none,hothiphop.parents,hot.parents
2019,1,WCR2019_1692,3,WCR2019_0223,WCR2019_0061,within-group subordinate,within-group subordinate,56,16,40,41,28,57,44,1,99999,485,751,422,0.249705535924617,0,0,NA,NA,none,hothiphop.parents,hot.parents
2019,1,WCR2019_1741,1,WCR2019_0223,WCR2019_0087,within-group subordinate,within-group subordinate,57,23,34,32,31,55,54,1,99999,485,622,353,0.352872215709261,0,0,NA,NA,none,hothiphop.parents,hot.parents
2019,1,WCR2019_1741,2,WCR2019_0440,WCR2019_0087,within-group subordinate,within-group subordinate,58,19,39,29,31,48,50,1,99999,565,622,411,0.352872215709261,0,0,NA,NA,none,hothiphop.parents,hot.parents
2019,1,WCR2019_1741,3,WCR2019_0191,WCR2019_0087,within-group subordinate,within-group subordinate,69,27,42,36,31,63,58,1,99999,648,622,458,0.352872215709261,0,0,NA,NA,none,hothiphop.parents,hot.parents
2019,1,WCR2019_1744,1,WCR2019_0474,WCR2019_0451,within-group subordinate,within-group subordinate,2,1,1,1,3,2,4,1,99999,721,837,719,0.0595238095238095,0,0,NA,NA,none,hothiphop.parents,hot.parents
2019,1,WCR2019_1744,2,WCR2019_0252,WCR2019_0039,within-group subordinate,within-group subordinate,4,2,2,0,2,2,4,1,99999,837,820,817,0.0595238095238095,0,0,NA,NA,none,hothiphop.parents,hot.parents
2019,1,WCR2019_1744,3,WCR2019_0252,WCR2019_0398,within-group subordinate,within-group subordinate,4,2,2,0,2,2,4,1,99999,837,839,836,0.0595238095238095,0,0,NA,NA,none,hothiphop.parents,hot.parents
2019,1,WCR2019_1745,1,WCR2019_0479,WCR2019_0405,within-group subordinate,within-group subordinate,1,1,0,0,0,1,1,1,99999,718,677,675,0.238888888888889,0,0,NA,NA,none,hothiphop.parents,hot.parents
2019,1,WCR2019_1745,2,WCR2019_0479,WCR2019_0039,within-group subordinate,within-group subordinate,4,2,2,0,2,2,4,1,99999,718,706,704,0.238888888888889,0,0,NA,NA,none,hothiphop.parents,hot.parents
2019,1,WCR2019_1745,3,WCR2019_0479,WCR2019_0122,within-group subordinate,within-group subordinate,4,2,2,0,2,2,4,1,99999,718,709,707,0.238888888888889,0,0,NA,NA,none,hothiphop.parents,hot.parents
2019,1,WCR2019_1746,1,WCR2019_0223,WCR2019_0088,within-group subordinate,within-group subordinate,49,21,28,22,25,43,46,1,99999,471,625,366,0.434782608695652,0,0,NA,NA,none,hothiphop.parents,hot.parents
2019,1,WCR2019_1746,2,WCR2019_0223,WCR2019_0061,within-group subordinate,within-group subordinate,51,23,28,22,28,45,51,1,99999,471,736,412,0.434782608695652,0,0,NA,NA,none,hothiphop.parents,hot.parents
2019,1,WCR2019_1746,3,WCR2019_0440,WCR2019_0088,within-group subordinate,within-group subordinate,53,26,27,26,25,52,51,1,99999,549,625,419,0.434782608695652,0,0,NA,NA,none,hothiphop.parents,hot.parents
2019,1,WCR2019_1748,1,WCR2019_0223,WCR2019_0087,within-group subordinate,within-group subordinate,46,14,32,18,38,32,52,1,99999,459,597,338,0.412855377008653,0,0,NA,NA,none,hothiphop.parents,hot.parents
2019,1,WCR2019_1748,2,WCR2019_0223,WCR2019_0061,within-group subordinate,within-group subordinate,60,31,29,18,32,49,63,1,99999,459,719,401,0.412855377008653,0,0,NA,NA,none,hothiphop.parents,hot.parents
2019,1,WCR2019_1748,3,WCR2019_0223,WCR2019_0073,within-group subordinate,within-group subordinate,60,25,35,18,48,43,73,1,99999,459,742,411,0.412855377008653,0,0,NA,NA,none,hothiphop.parents,hot.parents
2019,1,WCR2019_1749,1,WCR2019_0223,WCR2019_0088,within-group subordinate,within-group subordinate,39,13,26,23,15,36,28,1,99999,468,622,370,0.319123020706456,0,0,NA,NA,none,hothiphop.parents,hot.parents
2019,1,WCR2019_1749,2,WCR2019_0223,WCR2019_0206,within-group subordinate,within-group subordinate,40,15,25,23,8,38,23,1,99999,468,810,465,0.319123020706456,0,0,NA,NA,none,hothiphop.parents,hot.parents
2019,1,WCR2019_1749,3,WCR2019_0223,WCR2019_0327,within-group subordinate,within-group subordinate,42,15,27,23,9,38,24,1,99999,468,790,453,0.319123020706456,0,0,NA,NA,none,hothiphop.parents,hot.parents
2019,1,WCR2019_1750,1,WCR2019_0493,WCR2019_0327,within-group subordinate,within-group subordinate,36,23,13,1,12,24,35,1,99999,785,764,759,0.379266750948167,0,0,NA,NA,none,hothiphop.parents,hot.parents
2019,1,WCR2019_1750,2,WCR2019_0223,WCR2019_0327,within-group subordinate,within-group subordinate,37,14,23,19,12,33,26,1,99999,455,764,442,0.379266750948167,0,0,NA,NA,none,hothiphop.parents,hot.parents
2019,1,WCR2019_1750,3,WCR2019_0223,WCR2019_0061,within-group subordinate,within-group subordinate,38,18,20,19,18,37,36,1,99999,455,709,402,0.379266750948167,0,0,NA,NA,none,hothiphop.parents,hot.parents
2019,1,WCR2019_1751,1,WCR2019_0440,WCR2019_0122,within-group subordinate,within-group subordinate,50,23,27,18,24,41,47,1,99999,543,805,538,0.401960784313726,0,0,NA,NA,none,hothiphop.parents,hot.parents
2019,1,WCR2019_1751,2,WCR2019_0440,WCR2019_0087,within-group subordinate,within-group subordinate,54,26,28,18,33,44,59,1,99999,543,600,396,0.401960784313726,0,0,NA,NA,none,hothiphop.parents,hot.parents
2019,1,WCR2019_1751,3,WCR2019_0440,WCR2019_0327,within-group subordinate,within-group subordinate,57,34,23,18,28,52,62,1,99999,543,786,524,0.401960784313726,0,0,NA,NA,none,hothiphop.parents,hot.parents
2019,1,WCR2019_1752,1,WCR2019_0420,WCR2019_0325,within-group subordinate,within-group subordinate,1,0,1,0,1,0,1,1,99999,811,803,802,0.13423645320197,0,0,NA,NA,none,hothiphop.parents,hot.parents
2019,1,WCR2019_1752,2,WCR2019_0334,WCR2019_0325,within-group subordinate,within-group subordinate,4,1,3,2,1,3,2,1,99999,809,803,801,0.13423645320197,0,0,NA,NA,none,hothiphop.parents,hot.parents
2019,1,WCR2019_1752,3,WCR2019_0278,WCR2019_0325,within-group subordinate,within-group subordinate,5,1,4,3,1,4,2,1,99999,806,803,798,0.13423645320197,0,0,NA,NA,none,hothiphop.parents,hot.parents
2019,1,WCR2019_1753,1,WCR2019_0223,WCR2019_0161,within-group subordinate,within-group subordinate,39,24,15,16,12,40,36,1,99999,474,786,455,0.395209580838323,0,0,NA,NA,none,hothiphop.parents,hot.parents
2019,1,WCR2019_1753,2,WCR2019_0223,WCR2019_0088,within-group subordinate,within-group subordinate,41,21,20,16,19,37,40,1,99999,474,625,367,0.395209580838323,0,0,NA,NA,none,hothiphop.parents,hot.parents
2019,1,WCR2019_1753,3,WCR2019_0223,WCR2019_0327,within-group subordinate,within-group subordinate,41,20,21,16,12,36,32,1,99999,474,804,459,0.395209580838323,0,0,NA,NA,none,hothiphop.parents,hot.parents
2019,1,WCR2019_1754,1,WCR2019_0467,WCR2019_0039,within-group subordinate,within-group subordinate,2,2,0,1,0,3,2,1,99999,589,575,575,0.0696095076400679,0,0,NA,NA,none,hothiphop.parents,hot.parents
2019,1,WCR2019_1754,2,WCR2019_0310,WCR2019_0388,within-group subordinate,within-group subordinate,2,0,2,1,1,1,1,1,99999,584,588,583,0.0696095076400679,0,0,NA,NA,none,hothiphop.parents,hot.parents
2019,1,WCR2019_1754,3,WCR2019_0409,WCR2019_0039,within-group subordinate,within-group subordinate,3,3,0,1,0,4,3,1,99999,586,575,572,0.0696095076400679,0,0,NA,NA,none,hothiphop.parents,hot.parents
2019,1,WCR2019_1755,1,WCR2019_0440,WCR2019_0327,within-group subordinate,within-group subordinate,67,29,38,30,25,59,54,1,99999,561,818,542,0.349056603773585,0,0,NA,NA,none,hothiphop.parents,hot.parents
2019,1,WCR2019_1755,2,WCR2019_0223,WCR2019_0087,within-group subordinate,within-group subordinate,68,25,43,33,46,58,71,1,99999,481,616,349,0.349056603773585,0,0,NA,NA,none,hothiphop.parents,hot.parents
2019,1,WCR2019_1755,3,WCR2019_0223,WCR2019_0327,within-group subordinate,within-group subordinate,69,31,38,33,25,64,56,1,99999,481,818,466,0.349056603773585,0,0,NA,NA,none,hothiphop.parents,hot.parents
2019,1,WCR2019_1756,1,WCR2019_0223,WCR2019_0087,within-group subordinate,within-group subordinate,49,22,27,27,28,49,50,1,99999,456,593,336,0.395291201982652,0,0,NA,NA,none,hothiphop.parents,hot.parents
2019,1,WCR2019_1756,2,WCR2019_0440,WCR2019_0087,within-group subordinate,within-group subordinate,60,23,37,29,28,52,51,1,99999,536,593,392,0.395291201982652,0,0,NA,NA,none,hothiphop.parents,hot.parents
2019,1,WCR2019_1756,3,WCR2019_0191,WCR2019_0087,within-group subordinate,within-group subordinate,63,27,36,24,28,51,55,1,99999,613,593,435,0.395291201982652,0,0,NA,NA,none,hothiphop.parents,hot.parents
2019,1,WCR2019_1757,1,WCR2019_0223,WCR2019_0061,within-group subordinate,within-group subordinate,41,22,19,17,16,39,38,1,99999,477,744,417,0.426523297491039,0,0,NA,NA,none,hothiphop.parents,hot.parents
2019,1,WCR2019_1757,2,WCR2019_0223,WCR2019_0122,within-group subordinate,within-group subordinate,41,22,19,17,10,39,32,1,99999,477,826,470,0.426523297491039,0,0,NA,NA,none,hothiphop.parents,hot.parents
2019,1,WCR2019_1757,3,WCR2019_0440,WCR2019_0122,within-group subordinate,within-group subordinate,41,21,20,16,10,37,31,1,99999,555,826,549,0.426523297491039,0,0,NA,NA,none,hothiphop.parents,hot.parents
2019,1,WCR2019_1758,1,WCR2019_0252,WCR2019_0405,within-group subordinate,within-group subordinate,2,1,1,1,0,2,1,1,99999,810,767,764,0.0590405904059041,0,0,NA,NA,none,hothiphop.parents,hot.parents
2019,1,WCR2019_1758,2,WCR2019_0119,WCR2019_0405,within-group subordinate,within-group subordinate,3,3,0,2,0,5,3,1,99999,812,767,767,0.0590405904059041,0,0,NA,NA,none,hothiphop.parents,hot.parents
2019,1,WCR2019_1758,3,WCR2019_0579,WCR2019_0405,within-group subordinate,within-group subordinate,3,1,2,2,0,3,1,1,99999,807,767,761,0.0590405904059041,0,0,NA,NA,none,hothiphop.parents,hot.parents
2019,1,WCR2019_1759,1,WCR2019_0440,WCR2019_0122,within-group subordinate,within-group subordinate,45,19,26,19,23,38,42,1,99999,494,729,489,0.444594594594595,0,0,NA,NA,none,hothiphop.parents,hot.parents
2019,1,WCR2019_1759,2,WCR2019_0440,WCR2019_0327,within-group subordinate,within-group subordinate,56,33,23,19,17,52,50,1,99999,494,714,479,0.444594594594595,0,0,NA,NA,none,hothiphop.parents,hot.parents
2019,1,WCR2019_1759,3,WCR2019_0223,WCR2019_0087,within-group subordinate,within-group subordinate,57,29,28,20,39,49,68,1,99999,413,557,308,0.444594594594595,0,0,NA,NA,none,hothiphop.parents,hot.parents
2019,1,WCR2019_1760,1,WCR2019_0223,WCR2019_0079,within-group subordinate,within-group subordinate,48,23,25,24,1,47,24,1,99999,466,816,463,0.376829268292683,0,0,NA,NA,none,hothiphop.parents,hot.parents
2019,1,WCR2019_1760,2,WCR2019_0223,WCR2019_0061,within-group subordinate,within-group subordinate,52,22,30,24,35,46,57,1,99999,466,732,411,0.376829268292683,0,0,NA,NA,none,hothiphop.parents,hot.parents
2019,1,WCR2019_1760,3,WCR2019_0440,WCR2019_0079,within-group subordinate,within-group subordinate,59,27,32,32,1,59,28,1,99999,542,816,539,0.376829268292683,0,0,NA,NA,none,hothiphop.parents,hot.parents
2019,1,WCR2019_1761,1,WCR2019_0223,WCR2019_0061,within-group subordinate,within-group subordinate,55,31,24,18,33,49,64,1,99999,465,728,408,0.402200488997555,0,0,NA,NA,none,hothiphop.parents,hot.parents
2019,1,WCR2019_1761,2,WCR2019_0223,WCR2019_0087,within-group subordinate,within-group subordinate,56,23,33,18,47,41,70,1,99999,465,594,338,0.402200488997555,0,0,NA,NA,none,hothiphop.parents,hot.parents
2019,1,WCR2019_1761,3,WCR2019_0223,WCR2019_0073,within-group subordinate,within-group subordinate,61,28,33,18,48,46,76,1,99999,465,750,418,0.402200488997555,0,0,NA,NA,none,hothiphop.parents,hot.parents
2019,1,WCR2019_1762,1,WCR2019_0223,WCR2019_0088,within-group subordinate,within-group subordinate,23,15,8,12,4,27,19,1,99999,454,617,363,0.409876543209877,0,0,NA,NA,none,hothiphop.parents,hot.parents
2019,1,WCR2019_1762,2,WCR2019_0223,WCR2019_0327,within-group subordinate,within-group subordinate,30,17,13,12,3,29,20,1,99999,454,780,439,0.409876543209877,0,0,NA,NA,none,hothiphop.parents,hot.parents
2019,1,WCR2019_1762,3,WCR2019_0223,WCR2019_0039,within-group subordinate,within-group subordinate,31,20,11,12,6,32,26,1,99999,454,788,442,0.409876543209877,0,0,NA,NA,none,hothiphop.parents,hot.parents
2019,1,WCR2019_1763,1,WCR2019_0223,WCR2019_0327,within-group subordinate,within-group subordinate,55,30,25,21,23,51,53,1,99999,477,813,464,0.414489311163895,0,0,NA,NA,none,hothiphop.parents,hot.parents
2019,1,WCR2019_1763,2,WCR2019_0223,WCR2019_0061,within-group subordinate,within-group subordinate,55,26,29,21,34,47,60,1,99999,477,746,416,0.414489311163895,0,0,NA,NA,none,hothiphop.parents,hot.parents
2019,1,WCR2019_1763,3,WCR2019_0223,WCR2019_0088,within-group subordinate,within-group subordinate,59,25,34,21,39,46,64,1,99999,477,636,375,0.414489311163895,0,0,NA,NA,none,hothiphop.parents,hot.parents
2019,1,WCR2019_1764,1,WCR2019_0532,WCR2019_0327,within-group subordinate,within-group subordinate,58,39,19,2,19,41,58,1,99999,843,823,812,0.375878220140515,0,0,NA,NA,none,hothiphop.parents,hot.parents
2019,1,WCR2019_1764,2,WCR2019_0223,WCR2019_0087,within-group subordinate,within-group subordinate,61,27,34,24,34,51,61,1,99999,485,622,353,0.375878220140515,0,0,NA,NA,none,hothiphop.parents,hot.parents
2019,1,WCR2019_1764,3,WCR2019_0223,WCR2019_0327,within-group subordinate,within-group subordinate,62,31,31,24,19,55,50,1,99999,485,823,470,0.375878220140515,0,0,NA,NA,none,hothiphop.parents,hot.parents
2019,1,WCR2019_1765,1,WCR2019_0223,WCR2019_0087,within-group subordinate,within-group subordinate,58,20,38,25,44,45,64,1,99999,480,609,349,0.363528009535161,0,0,NA,NA,none,hothiphop.parents,hot.parents
2019,1,WCR2019_1765,2,WCR2019_0223,WCR2019_0073,within-group subordinate,within-group subordinate,64,22,42,25,59,47,81,1,99999,480,768,429,0.363528009535161,0,0,NA,NA,none,hothiphop.parents,hot.parents
2019,1,WCR2019_1765,3,WCR2019_0440,WCR2019_0087,within-group subordinate,within-group subordinate,64,17,47,33,44,50,61,1,99999,555,609,402,0.363528009535161,0,0,NA,NA,none,hothiphop.parents,hot.parents
2019,1,WCR2019_1766,1,WCR2019_0280,WCR2019_0286,within-group subordinate,within-group subordinate,4,0,4,2,2,2,2,1,99999,773,783,767,0.379266750948167,0,0,NA,NA,none,hothiphop.parents,hot.parents
2019,1,WCR2019_1766,2,WCR2019_0280,WCR2019_0122,within-group subordinate,within-group subordinate,42,21,21,2,20,23,41,1,99999,773,779,761,0.379266750948167,0,0,NA,NA,none,hothiphop.parents,hot.parents
2019,1,WCR2019_1766,3,WCR2019_0440,WCR2019_0286,within-group subordinate,within-group subordinate,49,25,24,24,2,49,27,1,99999,527,783,523,0.379266750948167,0,0,NA,NA,none,hothiphop.parents,hot.parents
2019,1,WCR2019_1767,1,WCR2019_0440,WCR2019_0087,within-group subordinate,within-group subordinate,56,28,28,14,32,42,60,1,99999,539,590,394,0.425030978934325,0,0,NA,NA,none,hothiphop.parents,hot.parents
2019,1,WCR2019_1767,2,WCR2019_0223,WCR2019_0087,within-group subordinate,within-group subordinate,57,25,32,28,32,53,57,1,99999,464,590,338,0.425030978934325,0,0,NA,NA,none,hothiphop.parents,hot.parents
2019,1,WCR2019_1767,3,WCR2019_0223,WCR2019_0073,within-group subordinate,within-group subordinate,61,23,38,28,36,51,59,1,99999,464,741,416,0.425030978934325,0,0,NA,NA,none,hothiphop.parents,hot.parents
2019,1,WCR2019_1768,1,WCR2019_0223,WCR2019_0088,within-group subordinate,within-group subordinate,34,20,14,16,1,36,21,1,99999,488,642,380,0.44131455399061,0,0,NA,NA,none,hothiphop.parents,hot.parents
2019,1,WCR2019_1768,2,WCR2019_0473,WCR2019_0327,within-group subordinate,within-group subordinate,35,18,17,13,5,31,23,1,99999,849,821,819,0.44131455399061,0,0,NA,NA,none,hothiphop.parents,hot.parents
2019,1,WCR2019_1768,3,WCR2019_0473,WCR2019_0088,within-group subordinate,within-group subordinate,36,24,12,13,1,37,25,1,99999,849,642,640,0.44131455399061,0,0,NA,NA,none,hothiphop.parents,hot.parents
2019,1,WCR2019_1769,1,WCR2019_0223,WCR2019_0088,within-group subordinate,within-group subordinate,43,19,24,15,26,34,45,1,99999,359,461,280,0.495065789473684,0,0,NA,NA,none,hothiphop.parents,hot.parents
2019,1,WCR2019_1769,2,WCR2019_0223,WCR2019_0327,within-group subordinate,within-group subordinate,45,26,19,15,7,41,33,1,99999,359,583,347,0.495065789473684,0,0,NA,NA,none,hothiphop.parents,hot.parents
2019,1,WCR2019_1769,3,WCR2019_0223,WCR2019_0161,within-group subordinate,within-group subordinate,47,27,20,15,20,42,47,1,99999,359,576,344,0.495065789473684,0,0,NA,NA,none,hothiphop.parents,hot.parents
2019,1,WCR2019_1770,1,WCR2019_0566,WCR2019_0413,within-group subordinate,within-group subordinate,40,17,23,0,23,17,40,1,99999,805,805,803,0.42998760842627,0,0,NA,NA,none,hothiphop.parents,hot.parents
2019,1,WCR2019_1770,2,WCR2019_0223,WCR2019_0327,within-group subordinate,within-group subordinate,43,22,21,18,18,40,40,1,99999,458,778,444,0.42998760842627,0,0,NA,NA,none,hothiphop.parents,hot.parents
2019,1,WCR2019_1770,3,WCR2019_0223,WCR2019_0088,within-group subordinate,within-group subordinate,48,25,23,18,31,43,56,1,99999,458,616,361,0.42998760842627,0,0,NA,NA,none,hothiphop.parents,hot.parents
2019,1,WCR2019_1771,1,WCR2019_0263,WCR2019_0206,within-group subordinate,within-group subordinate,26,13,13,10,3,23,16,1,99999,787,785,780,0.279245283018868,0,0,NA,NA,none,hothiphop.parents,hot.parents
2019,1,WCR2019_1771,2,WCR2019_0493,WCR2019_0206,within-group subordinate,within-group subordinate,27,15,12,9,3,24,18,1,99999,789,785,779,0.279245283018868,0,0,NA,NA,none,hothiphop.parents,hot.parents
2019,1,WCR2019_1771,3,WCR2019_0011,WCR2019_0206,within-group subordinate,within-group subordinate,27,14,13,12,3,26,17,1,99999,794,785,784,0.279245283018868,0,0,NA,NA,none,hothiphop.parents,hot.parents
2019,1,WCR2019_1773,1,WCR2019_0223,WCR2019_0161,within-group subordinate,within-group subordinate,45,26,19,15,14,41,40,1,99999,415,669,396,0.442877291960508,0,0,NA,NA,none,hothiphop.parents,hot.parents
2019,1,WCR2019_1773,2,WCR2019_0223,WCR2019_0122,within-group subordinate,within-group subordinate,49,29,20,15,13,44,42,1,99999,415,698,409,0.442877291960508,0,0,NA,NA,none,hothiphop.parents,hot.parents
2019,1,WCR2019_1773,3,WCR2019_0223,WCR2019_0327,within-group subordinate,within-group subordinate,50,30,20,15,13,45,43,1,99999,415,681,401,0.442877291960508,0,0,NA,NA,none,hothiphop.parents,hot.parents
2019,1,WCR2019_1774,1,WCR2019_0223,WCR2019_0088,within-group subordinate,within-group subordinate,40,19,21,17,21,36,40,1,99999,414,553,331,0.463788300835655,0,0,NA,NA,none,hothiphop.parents,hot.parents
2019,1,WCR2019_1774,2,WCR2019_0223,WCR2019_0161,within-group subordinate,within-group subordinate,46,25,21,17,20,42,45,1,99999,414,672,396,0.463788300835655,0,0,NA,NA,none,hothiphop.parents,hot.parents
2019,1,WCR2019_1774,3,WCR2019_0223,WCR2019_0061,within-group subordinate,within-group subordinate,49,26,23,17,25,43,51,1,99999,414,642,365,0.463788300835655,0,0,NA,NA,none,hothiphop.parents,hot.parents
2019,1,WCR2019_1775,1,WCR2019_0223,WCR2019_0087,within-group subordinate,within-group subordinate,56,23,33,25,39,48,62,1,99999,475,607,344,0.379186602870813,0,0,NA,NA,none,hothiphop.parents,hot.parents
2019,1,WCR2019_1775,2,WCR2019_0223,WCR2019_0153,within-group subordinate,within-group subordinate,59,33,26,25,2,58,35,1,99999,475,832,473,0.379186602870813,0,0,NA,NA,none,hothiphop.parents,hot.parents
2019,1,WCR2019_1775,3,WCR2019_0223,WCR2019_0327,within-group subordinate,within-group subordinate,62,27,35,25,29,52,56,1,99999,475,806,461,0.379186602870813,0,0,NA,NA,none,hothiphop.parents,hot.parents
2019,1,WCR2019_1776,1,WCR2019_0223,WCR2019_0087,within-group subordinate,within-group subordinate,65,23,42,27,51,50,74,1,99999,473,612,347,0.382775119617225,0,0,NA,NA,none,hothiphop.parents,hot.parents
2019,1,WCR2019_1776,2,WCR2019_0223,WCR2019_0327,within-group subordinate,within-group subordinate,68,32,36,27,27,59,59,1,99999,473,807,460,0.382775119617225,0,0,NA,NA,none,hothiphop.parents,hot.parents
2019,1,WCR2019_1776,3,WCR2019_0223,WCR2019_0161,within-group subordinate,within-group subordinate,70,28,42,27,40,55,68,1,99999,473,786,454,0.382775119617225,0,0,NA,NA,none,hothiphop.parents,hot.parents
2019,1,WCR2019_1777,1,WCR2019_0394,WCR2019_0327,within-group subordinate,within-group subordinate,39,28,11,1,10,29,38,1,99999,815,786,785,0.401960784313726,0,0,NA,NA,none,hothiphop.parents,hot.parents
2019,1,WCR2019_1777,2,WCR2019_0394,WCR2019_0122,within-group subordinate,within-group subordinate,45,21,24,1,23,22,44,1,99999,815,804,803,0.401960784313726,0,0,NA,NA,none,hothiphop.parents,hot.parents
2019,1,WCR2019_1777,3,WCR2019_0394,WCR2019_0161,within-group subordinate,within-group subordinate,49,25,24,1,23,26,48,1,99999,815,769,768,0.401960784313726,0,0,NA,NA,none,hothiphop.parents,hot.parents
2019,1,WCR2019_1779,1,WCR2019_0223,WCR2019_0084,within-group subordinate,within-group subordinate,42,23,19,19,0,42,23,1,99999,479,837,478,0.384982121573302,0,0,NA,NA,none,hothiphop.parents,hot.parents
2019,1,WCR2019_1779,2,WCR2019_0476,WCR2019_0084,within-group subordinate,within-group subordinate,47,25,22,22,0,47,25,1,99999,836,837,834,0.384982121573302,0,0,NA,NA,none,hothiphop.parents,hot.parents
2019,1,WCR2019_1779,3,WCR2019_0223,WCR2019_0087,within-group subordinate,within-group subordinate,50,21,29,19,32,40,53,1,99999,479,615,351,0.384982121573302,0,0,NA,NA,none,hothiphop.parents,hot.parents
2019,1,WCR2019_1780,1,WCR2019_0566,WCR2019_0327,within-group subordinate,within-group subordinate,43,33,10,0,11,33,44,1,99999,818,791,788,0.412911084043849,0,0,NA,NA,none,hothiphop.parents,hot.parents
2019,1,WCR2019_1780,2,WCR2019_0566,WCR2019_0122,within-group subordinate,within-group subordinate,46,32,14,0,14,32,46,1,99999,818,810,807,0.412911084043849,0,0,NA,NA,none,hothiphop.parents,hot.parents
2019,1,WCR2019_1780,3,WCR2019_0566,WCR2019_0161,within-group subordinate,within-group subordinate,51,34,17,0,17,34,51,1,99999,818,774,771,0.412911084043849,0,0,NA,NA,none,hothiphop.parents,hot.parents
2019,1,WCR2019_1781,1,WCR2019_0223,WCR2019_0327,within-group subordinate,within-group subordinate,55,24,31,28,26,52,50,1,99999,461,788,446,0.367521367521368,0,0,NA,NA,none,hothiphop.parents,hot.parents
2019,1,WCR2019_1781,2,WCR2019_0223,WCR2019_0087,within-group subordinate,within-group subordinate,57,20,37,28,45,48,65,1,99999,461,604,340,0.367521367521368,0,0,NA,NA,none,hothiphop.parents,hot.parents
2019,1,WCR2019_1781,3,WCR2019_0223,WCR2019_0061,within-group subordinate,within-group subordinate,61,19,42,28,44,47,63,1,99999,461,727,403,0.367521367521368,0,0,NA,NA,none,hothiphop.parents,hot.parents
2019,1,WCR2019_1782,1,WCR2019_0223,WCR2019_0087,within-group subordinate,within-group subordinate,52,26,26,22,33,48,59,1,99999,449,589,332,0.422641509433962,0,0,NA,NA,none,hothiphop.parents,hot.parents
2019,1,WCR2019_1782,2,WCR2019_0223,WCR2019_0061,within-group subordinate,within-group subordinate,64,33,31,22,35,55,68,1,99999,449,708,395,0.422641509433962,0,0,NA,NA,none,hothiphop.parents,hot.parents
2019,1,WCR2019_1782,3,WCR2019_0440,WCR2019_0087,within-group subordinate,within-group subordinate,64,30,34,24,33,54,63,1,99999,528,589,390,0.422641509433962,0,0,NA,NA,none,hothiphop.parents,hot.parents
2019,1,WCR2019_1783,1,WCR2019_0223,WCR2019_0279,within-group subordinate,within-group subordinate,65,33,32,31,2,64,35,1,99999,474,827,473,0.391826923076923,0,0,NA,NA,none,hothiphop.parents,hot.parents
2019,1,WCR2019_1783,2,WCR2019_0440,WCR2019_0279,within-group subordinate,within-group subordinate,66,35,31,31,2,66,37,1,99999,559,827,558,0.391826923076923,0,0,NA,NA,none,hothiphop.parents,hot.parents
2019,1,WCR2019_1783,3,WCR2019_0223,WCR2019_0087,within-group subordinate,within-group subordinate,67,20,47,31,48,51,68,1,99999,474,612,350,0.391826923076923,0,0,NA,NA,none,hothiphop.parents,hot.parents
2019,1,WCR2019_1784,1,WCR2019_0267,WCR2019_0327,within-group subordinate,within-group subordinate,34,27,7,7,4,34,31,1,99999,794,777,765,0.299504950495049,0,0,NA,NA,none,hothiphop.parents,hot.parents
2019,1,WCR2019_1784,2,WCR2019_0192,WCR2019_0327,within-group subordinate,within-group subordinate,35,24,11,8,4,32,28,1,99999,807,777,776,0.299504950495049,0,0,NA,NA,none,hothiphop.parents,hot.parents
2019,1,WCR2019_1784,3,WCR2019_0223,WCR2019_0088,within-group subordinate,within-group subordinate,35,13,22,27,2,40,15,1,99999,464,617,364,0.299504950495049,0,0,NA,NA,none,hothiphop.parents,hot.parents
2019,1,WCR2019_1785,1,WCR2019_0223,WCR2019_0327,within-group subordinate,within-group subordinate,38,21,17,12,9,33,30,1,99999,467,785,453,0.450306748466258,0,0,NA,NA,none,hothiphop.parents,hot.parents
2019,1,WCR2019_1785,2,WCR2019_0223,WCR2019_0161,within-group subordinate,within-group subordinate,41,26,15,12,13,38,39,1,99999,467,768,448,0.450306748466258,0,0,NA,NA,none,hothiphop.parents,hot.parents
2019,1,WCR2019_1785,3,WCR2019_0223,WCR2019_0088,within-group subordinate,within-group subordinate,43,27,16,12,20,39,47,1,99999,467,619,368,0.450306748466258,0,0,NA,NA,none,hothiphop.parents,hot.parents
2019,1,WCR2019_1786,1,WCR2019_0534,WCR2019_0066,within-group subordinate,within-group subordinate,20,11,9,9,0,20,11,1,99999,831,830,826,0.372455089820359,0,0,NA,NA,none,hothiphop.parents,hot.parents
2019,1,WCR2019_1786,2,WCR2019_0223,WCR2019_0327,within-group subordinate,within-group subordinate,48,17,31,30,14,47,31,1,99999,473,804,458,0.372455089820359,0,0,NA,NA,none,hothiphop.parents,hot.parents
2019,1,WCR2019_1786,3,WCR2019_0223,WCR2019_0075,within-group subordinate,within-group subordinate,53,23,30,30,25,53,48,1,99999,473,731,407,0.372455089820359,0,0,NA,NA,none,hothiphop.parents,hot.parents
2019,1,WCR2019_1787,1,WCR2019_0559,WCR2019_0539,within-group subordinate,within-group subordinate,6,0,6,2,4,2,4,1,99999,817,816,807,0.36319612590799,0,0,NA,NA,none,hothiphop.parents,hot.parents
2019,1,WCR2019_1787,2,WCR2019_0379,WCR2019_0539,within-group subordinate,within-group subordinate,38,23,15,11,4,34,27,1,99999,816,816,806,0.36319612590799,0,0,NA,NA,none,hothiphop.parents,hot.parents
2019,1,WCR2019_1787,3,WCR2019_0399,WCR2019_0539,within-group subordinate,within-group subordinate,39,23,16,13,4,36,27,1,99999,825,816,815,0.36319612590799,0,0,NA,NA,none,hothiphop.parents,hot.parents
2019,1,WCR2019_1788,1,WCR2019_0395,WCR2019_0327,within-group subordinate,within-group subordinate,46,20,26,1,25,21,45,1,99999,847,827,817,0.377622377622378,0,0,NA,NA,none,hothiphop.parents,hot.parents
2019,1,WCR2019_1788,2,WCR2019_0395,WCR2019_0122,within-group subordinate,within-group subordinate,55,27,28,1,27,28,54,1,99999,847,846,835,0.377622377622378,0,0,NA,NA,none,hothiphop.parents,hot.parents
2019,1,WCR2019_1788,3,WCR2019_0395,WCR2019_0161,within-group subordinate,within-group subordinate,62,33,29,1,28,34,61,1,99999,847,808,799,0.377622377622378,0,0,NA,NA,none,hothiphop.parents,hot.parents
2019,1,WCR2019_1789,1,WCR2019_0440,WCR2019_0087,within-group subordinate,within-group subordinate,58,26,32,21,44,47,70,1,99999,559,621,408,0.36438679245283,0,0,NA,NA,none,hothiphop.parents,hot.parents
2019,1,WCR2019_1789,2,WCR2019_0223,WCR2019_0087,within-group subordinate,within-group subordinate,59,18,41,31,44,49,62,1,99999,485,621,354,0.36438679245283,0,0,NA,NA,none,hothiphop.parents,hot.parents
2019,1,WCR2019_1789,3,WCR2019_0223,WCR2019_0327,within-group subordinate,within-group subordinate,62,25,37,31,23,56,48,1,99999,485,817,470,0.36438679245283,0,0,NA,NA,none,hothiphop.parents,hot.parents
2019,1,WCR2019_1790,1,WCR2019_0223,WCR2019_0088,within-group subordinate,within-group subordinate,53,25,28,21,27,46,52,1,99999,483,642,377,0.422039859320047,0,0,NA,NA,none,hothiphop.parents,hot.parents
2019,1,WCR2019_1790,2,WCR2019_0223,WCR2019_0061,within-group subordinate,within-group subordinate,56,32,24,21,22,53,54,1,99999,483,757,422,0.422039859320047,0,0,NA,NA,none,hothiphop.parents,hot.parents
2019,1,WCR2019_1790,3,WCR2019_0223,WCR2019_0327,within-group subordinate,within-group subordinate,56,32,24,21,15,53,47,1,99999,483,822,468,0.422039859320047,0,0,NA,NA,none,hothiphop.parents,hot.parents
2019,1,WCR2019_1792,1,WCR2019_0223,WCR2019_0087,within-group subordinate,within-group subordinate,61,26,35,23,35,49,61,1,99999,441,582,329,0.39819587628866,0,0,NA,NA,none,hothiphop.parents,hot.parents
2019,1,WCR2019_1792,2,WCR2019_0223,WCR2019_0073,within-group subordinate,within-group subordinate,63,24,39,23,46,47,70,1,99999,441,716,398,0.39819587628866,0,0,NA,NA,none,hothiphop.parents,hot.parents
2019,1,WCR2019_1792,3,WCR2019_0223,WCR2019_0075,within-group subordinate,within-group subordinate,66,36,30,23,38,59,74,1,99999,441,681,378,0.39819587628866,0,0,NA,NA,none,hothiphop.parents,hot.parents
2019,1,WCR2019_1793,1,WCR2019_0223,WCR2019_0075,within-group subordinate,within-group subordinate,43,19,24,21,21,40,40,1,99999,447,698,385,0.36489898989899,0,0,NA,NA,none,hothiphop.parents,hot.parents
2019,1,WCR2019_1793,2,WCR2019_0223,WCR2019_0327,within-group subordinate,within-group subordinate,47,18,29,21,17,39,35,1,99999,447,764,433,0.36489898989899,0,0,NA,NA,none,hothiphop.parents,hot.parents
2019,1,WCR2019_1793,3,WCR2019_0440,WCR2019_0122,within-group subordinate,within-group subordinate,48,15,33,25,19,40,34,1,99999,521,780,515,0.36489898989899,0,0,NA,NA,none,hothiphop.parents,hot.parents
2019,1,WCR2019_1794,1,WCR2019_0223,WCR2019_0087,within-group subordinate,within-group subordinate,63,23,40,33,45,56,68,1,99999,452,588,332,0.359006211180124,0,0,NA,NA,none,hothiphop.parents,hot.parents
2019,1,WCR2019_1794,2,WCR2019_0440,WCR2019_0327,within-group subordinate,within-group subordinate,72,44,28,22,22,66,66,1,99999,538,774,518,0.359006211180124,0,0,NA,NA,none,hothiphop.parents,hot.parents
2019,1,WCR2019_1794,3,WCR2019_0223,WCR2019_0327,within-group subordinate,within-group subordinate,72,35,37,33,22,68,57,1,99999,452,774,437,0.359006211180124,0,0,NA,NA,none,hothiphop.parents,hot.parents
2019,1,WCR2019_1795,1,WCR2019_0223,WCR2019_0088,within-group subordinate,within-group subordinate,35,23,12,15,1,38,24,1,99999,476,629,372,0.473747016706444,0,0,NA,NA,none,hothiphop.parents,hot.parents
2019,1,WCR2019_1795,2,WCR2019_0223,WCR2019_0061,within-group subordinate,within-group subordinate,39,23,16,15,8,38,31,1,99999,476,746,419,0.473747016706444,0,0,NA,NA,none,hothiphop.parents,hot.parents
2019,1,WCR2019_1795,3,WCR2019_0223,WCR2019_0327,within-group subordinate,within-group subordinate,39,22,17,15,2,37,24,1,99999,476,807,461,0.473747016706444,0,0,NA,NA,none,hothiphop.parents,hot.parents
2019,1,WCR2019_1796,1,WCR2019_0223,WCR2019_0087,within-group subordinate,within-group subordinate,51,20,31,14,33,34,53,1,99999,456,596,340,0.390274314214464,0,0,NA,NA,none,hothiphop.parents,hot.parents
2019,1,WCR2019_1796,2,WCR2019_0223,WCR2019_0061,within-group subordinate,within-group subordinate,53,25,28,14,39,39,64,1,99999,456,712,399,0.390274314214464,0,0,NA,NA,none,hothiphop.parents,hot.parents
2019,1,WCR2019_1796,3,WCR2019_0223,WCR2019_0088,within-group subordinate,within-group subordinate,54,23,31,14,46,37,69,1,99999,456,612,358,0.390274314214464,0,0,NA,NA,none,hothiphop.parents,hot.parents
2019,1,WCR2019_1797,1,WCR2019_0223,WCR2019_0087,within-group subordinate,within-group subordinate,57,24,33,20,46,44,70,1,99999,461,606,343,0.386503067484663,0,0,NA,NA,none,hothiphop.parents,hot.parents
2019,1,WCR2019_1797,2,WCR2019_0440,WCR2019_0327,within-group subordinate,within-group subordinate,60,27,33,29,23,56,50,1,99999,540,788,522,0.386503067484663,0,0,NA,NA,none,hothiphop.parents,hot.parents
2019,1,WCR2019_1797,3,WCR2019_0223,WCR2019_0122,within-group subordinate,within-group subordinate,61,35,26,20,26,55,61,1,99999,461,805,455,0.386503067484663,0,0,NA,NA,none,hothiphop.parents,hot.parents
2019,1,WCR2019_1798,1,WCR2019_0223,WCR2019_0088,within-group subordinate,within-group subordinate,36,24,12,10,11,34,35,1,99999,458,610,359,0.474660074165637,0,0,NA,NA,none,hothiphop.parents,hot.parents
2019,1,WCR2019_1798,2,WCR2019_0223,WCR2019_0327,within-group subordinate,within-group subordinate,37,24,13,10,7,34,31,1,99999,458,781,445,0.474660074165637,0,0,NA,NA,none,hothiphop.parents,hot.parents
2019,1,WCR2019_1798,3,WCR2019_0440,WCR2019_0122,within-group subordinate,within-group subordinate,40,23,17,15,10,38,33,1,99999,534,797,528,0.474660074165637,0,0,NA,NA,none,hothiphop.parents,hot.parents
2019,1,WCR2019_1799,1,WCR2019_0223,WCR2019_0088,within-group subordinate,within-group subordinate,44,27,17,18,6,45,33,1,99999,484,638,377,0.477594339622642,0,0,NA,NA,none,hothiphop.parents,hot.parents
2019,1,WCR2019_1799,2,WCR2019_0223,WCR2019_0061,within-group subordinate,within-group subordinate,50,32,18,18,8,50,40,1,99999,484,751,422,0.477594339622642,0,0,NA,NA,none,hothiphop.parents,hot.parents
2019,1,WCR2019_1799,3,WCR2019_0440,WCR2019_0161,within-group subordinate,within-group subordinate,51,36,15,14,4,50,40,1,99999,562,798,539,0.477594339622642,0,0,NA,NA,none,hothiphop.parents,hot.parents
